1360,P,DNA-transposon,58917,795,41033,575,101320
1731,Copia,LTR-Retrotransposon,2336,120,1219,80,3755
17.6,Gypsy,LTR-Retrotransposon,343,188,287,162,980
297,Gypsy,LTR-Retrotransposon,69581,1683,52659,1527,125450
3S18,BEL,LTR-Retrotransposon,12834,239,6976,169,20218
412,Gypsy,LTR-Retrotransposon,54538,246,41938,189,96911
ACCORD2,Gypsy,LTR-Retrotransposon,14176,380,9356,281,24193
ACCORD2_I-INT:ACCORD2_LTR,Gypsy,LTR,5904,95,4877,65,10941
ACCORD2_I-INT,Gypsy,LTR,4574,440,3384,377,8775
ACCORD2_LTR:ACCORD2_I-INT,Gypsy,LTR,4176,163,3097,109,7545
ACCORD2_LTR,Gypsy,LTR,926,55,646,41,1668
ACCORD,Gyspy,LTR-Retrotransposon,1819,44,772,32,2667
ACCORD_I-INT:ACCORD_LTR,Gypsy,LTR,1750,56,944,33,2783
ACCORD_I-INT,Gypsy,LTR,7368,365,4187,267,12187
ACCORD_LTR:ACCORD_I-INT:ACCORD_LTR,Gypsy,LTR,793,21,335,14,1163
ACCORD_LTR:ACCORD_I-INT,Gypsy,LTR,301,14,143,11,469
ACCORD_LTR,Gypsy,LTR,1562,52,758,35,2407
BAGGINS1,LOA,LINE,139689,2437,93499,1732,237357
BAGGINS,Loa,non-LTR-Retrotransposon,20370,612,14138,506,35626
BARI1,TcMar-Tc1,DNA,1423,34,1380,30,2867
BARI_DM,TcMar-Tc1,DNA,125,53,109,46,333
BATUMI_I-INT:BATUMI_LTR,Pao,LTR,3752,71,2423,59,6305
BATUMI_I-INT,Pao,LTR,81686,1921,52701,1517,137825
BATUMI_LTR:BATUMI_I-INT,Pao,LTR,2588,39,1897,34,4558
BATUMI_LTR,Pao,LTR,715,14,548,12,1289
BEL-10_DAN-I,Pao,LTR,33,12,31,9,85
BEL-10_DAN-LTR,Pao,LTR,18,17,18,6,59
BEL-10_DBP-I,Pao,LTR,251,222,242,176,891
BEL-10_DBP-LTR,Pao,LTR,0,0,0,0,0
BEL-10_DEL-I,Pao,LTR,1188,28,924,18,2158
BEL-10_DTA-I,Pao,LTR,15,9,13,6,43
BEL-10_DTA-LTR,Pao,LTR,1,1,1,0,3
BEL-10_DWIL-I,Pao,LTR,604,248,494,218,1564
BEL-10_DWIL-LTR,Pao,LTR,0,0,0,0,0
BEL-11_DAN-I,Pao,LTR,3,2,3,0,8
BEL-11_DAN-LTR,Pao,LTR,1,1,1,0,3
BEL-11_DBP-I,Pao,LTR,15,6,12,5,38
BEL-11_DBP-LTR,Pao,LTR,0,0,0,0,0
BEL-11_DEL-I,Pao,LTR,735,69,633,59,1496
BEL-11_DTA-I,Pao,LTR,119,13,100,12,244
BEL-11_DTA-LTR,Pao,LTR,3,1,2,0,6
BEL-11_DWIL-I,Pao,LTR,50,18,36,10,114
BEL-12_DAN-I,Pao,LTR,38,3,13,3,57
BEL-12_DAN-LTR,Pao,LTR,0,0,0,0,0
BEL-12_DBP-I,Pao,LTR,30,16,28,10,84
BEL-12_DBP-LTR,Pao,LTR,0,0,0,0,0
BEL-12_DEL-I,Pao,LTR,244,100,204,91,639
BEL-12_DTA-I,Pao,LTR,395,19,294,10,718
BEL-12_DTA-LTR,Pao,LTR,5,0,5,0,10
BEL-12_DWIL-I,Pao,LTR,413,26,264,16,719
BEL-12_DWIL-LTR,Pao,LTR,34,16,25,16,91
BEL-13_DAN-I,Pao,LTR,83,15,57,12,167
BEL-13_DAN-LTR,Pao,LTR,0,0,0,0,0
BEL-13_DEL-I,Pao,LTR,366,46,249,22,683
BEL-13_DP-I,Pao,LTR,255,51,153,43,502
BEL-13_DP-LTR,Pao,LTR,5,1,3,1,10
BEL-13_DTA-I,Pao,LTR,28,11,26,5,70
BEL-13_DTA-LTR,Pao,LTR,0,0,0,0,0
BEL-13_DWIL-I,Pao,LTR,33,7,26,6,72
BEL-13_DWIL-LTR,Pao,LTR,7,0,3,0,10
BEL-14_DAN-I,Pao,LTR,55,27,47,21,150
BEL-14_DAN-LTR,Pao,LTR,2,0,2,0,4
BEL-14_DEL-I,Pao,LTR,4379,45,1638,30,6092
BEL-14_DP-I,Pao,LTR,469,109,376,83,1037
BEL-14_DP-LTR,Pao,LTR,99,60,89,48,296
BEL-14_DTA-I,Pao,LTR,550,421,514,403,1888
BEL-14_DTA-LTR,Pao,LTR,0,0,0,0,0
BEL-14_DWIL-I,Pao,LTR,80,27,70,21,198
BEL-14_DWIL-LTR,Pao,LTR,7,0,4,0,11
BEL-15_DAN-I,Pao,LTR,43,31,37,21,132
BEL-15_DAN-LTR,Pao,LTR,1,1,1,0,3
BEL-15_DEL-I,Pao,LTR,313,93,251,83,740
BEL-15_DP-I,Pao,LTR,82,46,69,30,227
BEL-15_DP-LTR,Pao,LTR,4,0,3,0,7
BEL-15_DTA-I,Pao,LTR,121,18,80,9,228
BEL-15_DTA-LTR,Pao,LTR,0,0,0,0,0
BEL-15_DWIL-I,Pao,LTR,179,10,102,6,297
BEL-15_DWIL-LTR,Pao,LTR,0,0,0,0,0
BEL-16_DAN-I,Pao,LTR,162,115,144,109,530
BEL-16_DAN-LTR,Pao,LTR,2,1,2,0,5
BEL-16_DEL-I,Pao,LTR,241,15,151,6,413
BEL-16_DEL-LTR,Pao,LTR,3,2,3,2,10
BEL-16_DTA-I,Pao,LTR,17,9,16,6,48
BEL-16_DTA-LTR,Pao,LTR,0,0,0,0,0
BEL-16_DWIL-I,Pao,LTR,37,25,32,21,115
BEL-16_DWIL-LTR,Pao,LTR,2,2,2,2,8
BEL-17_DAN-I,Pao,LTR,69,14,60,8,151
BEL-17_DAN-LTR,Pao,LTR,1,0,1,0,2
BEL-17_DEL-I,Pao,LTR,1462,120,734,81,2397
BEL-17_DEL-LTR,Pao,LTR,0,0,0,0,0
BEL-17_DTA-I,Pao,LTR,110,20,90,13,233
BEL-17_DTA-LTR,Pao,LTR,0,0,0,0,0
BEL-17_DWIL-LTR,Pao,LTR,0,0,0,0,0
BEL-18_DAN-I,Pao,LTR,11,4,10,3,28
BEL-18_DAN-LTR,Pao,LTR,0,0,0,0,0
BEL-18_DEL-I,Pao,LTR,87,22,70,9,188
BEL-18_DTA-I,Pao,LTR,19,9,17,6,51
BEL-18_DWIL-I,Pao,LTR,115,24,97,14,250
BEL-18_DWIL-LTR,Pao,LTR,0,0,0,0,0
BEL-19_DAN-I,Pao,LTR,554,171,409,142,1276
BEL-19_DAN-LTR,Pao,LTR,0,0,0,0,0
BEL-19_DTA-I,Pao,LTR,27,2,23,2,54
BEL-19_DTA-LTR,Pao,LTR,3,1,2,1,7
BEL-19_DWIL-I,Pao,LTR,61,6,41,6,114
BEL-19_DWIL-LTR,Pao,LTR,0,0,0,0,0
BEL-1_DAN-I,Pao,LTR,38,29,36,25,128
BEL-1_DAN-LTR,Pao,LTR,1,1,1,1,4
BEL-1_DBI-I,Pao,LTR,66,11,50,9,136
BEL-1_DBI-LTR,Pao,LTR,0,0,0,0,0
BEL-1_DBP-I,Pao,LTR,633,61,477,49,1220
BEL-1_DBP-LTR,Pao,LTR,1,1,1,1,4
BEL-1_DEL-I,Pao,LTR,747,194,519,145,1605
BEL-1_DERE-I,Pao,LTR,89,20,37,13,159
BEL-1_DERE-LTR,Pao,LTR,86,3,52,3,144
BEL-1_DEU-I,Pao,LTR,25,8,19,7,59
BEL-1_DFI-I,Pao,LTR,110,12,83,8,213
BEL-1_DGRI-I,Pao,LTR,23,6,13,5,47
BEL-1_DGRI-LTR,Pao,LTR,0,0,0,0,0
BEL-1_DKI-I,Pao,LTR,28,13,26,8,75
BEL-1_DKI-LTR,Pao,LTR,0,0,0,0,0
BEL-1_DPER-I,Pao,LTR,128,82,120,68,398
BEL-1_DPER-LTR,Pao,LTR,1,0,1,0,2
BEL-1_DRH-I:BEL-1_DRH-LTR,LTR,LTR,10,0,10,0,20
BEL-1_DRH-I,LTR,LTR,1660,138,1242,115,3155
BEL-1_DRH-LTR,LTR,LTR,14,8,12,5,39
BEL-1_DTA-I,Pao,LTR,29,10,23,9,71
BEL-1_DTA-LTR,Pao,LTR,2,2,2,2,8
BEL-1_DVIR-I,Pao,LTR,719,303,622,290,1934
BEL-1_DVIR-LTR,Pao,LTR,0,0,0,0,0
BEL-1_DWIL-I,Pao,LTR,425,37,316,31,809
BEL-1_DWIL-LTR,Pao,LTR,1,0,0,0,1
BEL1-I_DMOJ,Pao,LTR,68,33,55,29,185
BEL1_I_DPSE-INT,Pao,LTR,212,10,181,5,408
BEL1-I_DV,Pao,LTR,322,53,252,41,668
BEL1-I_DYA,Pao,LTR,347,192,315,156,1010
BEL1-LTR_DMOJ,Pao,LTR,1,1,1,0,3
BEL1_LTR_DPSE,Pao,LTR,1,1,1,0,3
BEL1-LTR_DV,Pao,LTR,0,0,0,0,0
BEL1-LTR_DYA:BEL1-I_DYA,Pao,LTR,33,28,33,19,113
BEL1-LTR_DYA,Pao,LTR,0,0,0,0,0
BEL-20_DAN-I,Pao,LTR,163,21,88,15,287
BEL-20_DAN-LTR,Pao,LTR,1,1,1,0,3
BEL-20_DTA-I,Pao,LTR,105,36,76,28,245
BEL-20_DTA-LTR,Pao,LTR,0,0,0,0,0
BEL-20_DWIL-I,Pao,LTR,82,9,62,8,161
BEL-20_DWIL-LTR,Pao,LTR,0,0,0,0,0
BEL-21_DAN-I,Pao,LTR,142,34,83,23,282
BEL-21_DAN-LTR,Pao,LTR,0,0,0,0,0
BEL-21_DTA-I,Pao,LTR,682,54,375,43,1154
BEL-21_DTA-LTR,Pao,LTR,0,0,0,0,0
BEL-21_DWIL-I,Pao,LTR,155,55,125,46,381
BEL-21_DWIL-LTR,Pao,LTR,0,0,0,0,0
BEL-22_DAN-I,Pao,LTR,92,79,89,74,334
BEL-22_DTA-I,Pao,LTR,976,30,707,27,1740
BEL-22_DTA-LTR,Pao,LTR,7,7,7,7,28
BEL-2_DAN-I,Pao,LTR,136,32,103,23,294
BEL-2_DAN-LTR,Pao,LTR,0,0,0,0,0
BEL-2_DBI-I:BEL-2_DBI-LTR,Pao,LTR,17,2,15,2,36
BEL-2_DBI-I,Pao,LTR,34,11,27,7,79
BEL-2_DBI-LTR,Pao,LTR,0,0,0,0,0
BEL-2_DBP-I,Pao,LTR,58,17,45,16,136
BEL-2_DBP-LTR,Pao,LTR,7,1,4,1,13
BEL-2_DEL-I,Pao,LTR,23,10,21,7,61
BEL-2_DEL-LTR,Pao,LTR,0,0,0,0,0
BEL-2_DEU-I,Pao,LTR,127,25,87,17,256
BEL-2_DEU-LTR,Pao,LTR,0,0,0,0,0
BEL-2_DFI-I,Pao,LTR,532,377,476,349,1734
BEL-2_DFI-LTR,Pao,LTR,1,0,1,0,2
BEL-2_DGRI-I,Pao,LTR,422,15,278,13,728
BEL-2_DGRI-LTR,Pao,LTR,6,6,6,6,24
BEL-2_DPER-I,Pao,LTR,447,165,350,138,1100
BEL-2_DPER-LTR,Pao,LTR,0,0,0,0,0
BEL-2_DRH-I,LTR,LTR,133,30,107,27,297
BEL-2_DRH-LTR,LTR,LTR,1,0,1,0,2
BEL-2_DSE-I:BEL-2_DSE-LTR,Pao,LTR,6960,61,3184,48,10253
BEL-2_DSE-I,Pao,LTR,13969,401,6939,326,21635
BEL-2_DSE-LTR:BEL-2_DSE-I:BEL-2_DSE-LTR,Pao,LTR,3233,45,1711,32,5021
BEL-2_DSE-LTR:BEL-2_DSE-I,Pao,LTR,6599,98,4919,78,11694
BEL-2_DSE-LTR,Pao,LTR,214,3,116,1,334
BEL-2_DTA-I,Pao,LTR,173,21,105,20,319
BEL-2_DTA-LTR,Pao,LTR,17,15,16,2,50
BEL-2_DVIR-I,Pao,LTR,215,150,193,134,692
BEL-2_DVIR-LTR,Pao,LTR,1,0,1,0,2
BEL-2_DWIL-I,Pao,LTR,100,17,82,13,212
BEL-2_DWIL-LTR,Pao,LTR,1,1,1,1,4
BEL2-I_DMOJ,Pao,LTR,253,29,194,22,498
BEL2-I_DPSE,Pao,LTR,126,8,73,4,211
BEL2-I_DYA,Pao,LTR,538,163,483,127,1311
BEL2-LTR_DMOJ,Pao,LTR,0,0,0,0,0
BEL2-LTR_DPSE,Pao,LTR,0,0,0,0,0
BEL2-LTR_DYA,Pao,LTR,17,11,15,6,49
BEL-3_DAN-I,Pao,LTR,63,6,48,3,120
BEL-3_DAN-LTR,Pao,LTR,21,0,19,0,40
BEL-3_DBI-I,Pao,LTR,236,11,178,8,433
BEL-3_DBI-LTR,Pao,LTR,0,0,0,0,0
BEL-3_DBP-I,Pao,LTR,176,124,167,104,571
BEL-3_DBP-LTR,Pao,LTR,1,1,1,1,4
BEL-3_DEL-I,Pao,LTR,1316,33,949,26,2324
BEL-3_DEL-LTR,Pao,LTR,38,0,28,0,66
BEL-3_DEU-I,Pao,LTR,166,28,133,21,348
BEL-3_DEU-LTR,Pao,LTR,0,0,0,0,0
BEL-3_DFI-I,Pao,LTR,546,38,335,30,949
BEL-3_DFI-LTR,Pao,LTR,0,0,0,0,0
BEL-3_DGRI-I,Pao,LTR,43,32,39,11,125
BEL-3_DGRI-LTR,Pao,LTR,2,0,2,0,4
BEL3_DM-I,Pao,LTR,166,19,129,15,329
BEL3_DM-LTR,Pao,LTR,1,0,1,0,2
BEL-3_DMOJ-I,Pao,LTR,20,9,18,6,53
BEL-3_DMOJ-LTR,Pao,LTR,3,3,3,3,12
BEL-3_DPER-I,Pao,LTR,125,68,116,39,348
BEL-3_DPER-LTR,Pao,LTR,0,0,0,0,0
BEL-3_DRH-I,LTR,LTR,129,92,125,83,429
BEL-3_DRH-LTR,LTR,LTR,0,0,0,0,0
BEL-3_DTA-I,Pao,LTR,3080,34,2263,29,5406
BEL-3_DTA-LTR,Pao,LTR,55,14,38,14,121
BEL-3_DVIR-I,Pao,LTR,294,52,182,44,572
BEL-3_DVIR-LTR,Pao,LTR,3,0,1,0,4
BEL-3_DWIL-I,Pao,LTR,28,14,25,12,79
BEL-3_DWIL-LTR,Pao,LTR,1,1,1,0,3
BEL-3_DYA-I,Pao,LTR,731,131,645,111,1618
BEL-3_DYA-LTR:BEL-3_DYA-I,Pao,LTR,9,7,9,4,29
BEL-3_DYA-LTR,Pao,LTR,18,15,17,13,63
BEL3-I_DPSE,Pao,LTR,24,10,19,6,59
BEL3-LTR_DPSE,Pao,LTR,1,0,1,0,2
BEL-4_DAN-I,Pao,LTR,111,39,103,36,289
BEL-4_DAN-LTR,Pao,LTR,0,0,0,0,0
BEL-4_DBI-I,Pao,LTR,168,72,157,46,443
BEL-4_DBI-LTR,Pao,LTR,6,0,4,0,10
BEL-4_DBP-I,Pao,LTR,86,23,71,19,199
BEL-4_DBP-LTR,Pao,LTR,1,1,1,1,4
BEL-4_DEL-I,Pao,LTR,424,286,366,271,1347
BEL-4_DEL-LTR,Pao,LTR,6,0,6,0,12
BEL-4_DEU-I,Pao,LTR,21,13,20,11,65
BEL-4_DEU-LTR,Pao,LTR,5,0,4,0,9
BEL-4_DFI-I:BEL-4_DFI-LTR,Pao,LTR,1,1,1,0,3
BEL-4_DFI-I,Pao,LTR,3025,2536,2909,2379,10849
BEL-4_DFI-LTR:BEL-4_DFI-I,Pao,LTR,22,22,22,21,87
BEL-4_DFI-LTR,Pao,LTR,11,0,3,0,14
BEL-4_DMOJ-I,Pao,LTR,51,33,50,28,162
BEL-4_DMOJ-LTR,Pao,LTR,11,7,10,4,32
BEL-4_DPER-I,Pao,LTR,72,36,63,26,197
BEL-4_DPER-LTR,Pao,LTR,3,0,2,0,5
BEL-4_DPSE-I,Pao,LTR,27,12,22,6,67
BEL-4_DPSE-LTR,Pao,LTR,0,0,0,0,0
BEL-4_DRH-I,LTR,LTR,91,14,61,6,172
BEL-4_DRH-LTR,LTR,LTR,2,2,2,1,7
BEL-4_DTA-I,Pao,LTR,62,11,42,10,125
BEL-4_DTA-LTR,Pao,LTR,0,0,0,0,0
BEL-4_DVIR-I,Pao,LTR,96,23,92,17,228
BEL-4_DVIR-LTR,Pao,LTR,0,0,0,0,0
BEL-4_DWIL-I,Pao,LTR,19,9,15,8,51
BEL-4_DWIL-LTR,Pao,LTR,1,0,0,0,1
BEL-4_DYA-I,Pao,LTR,422,49,259,29,759
BEL-4_DYA-LTR,Pao,LTR,0,0,0,0,0
BEL-5_DAN-I,Pao,LTR,32,7,26,3,68
BEL-5_DAN-LTR,Pao,LTR,8,1,7,1,17
BEL-5_DBP-I,Pao,LTR,3895,2142,3168,2038,11243
BEL-5_DBP-LTR,Pao,LTR,96,7,75,4,182
BEL-5_DEL-I,Pao,LTR,285,3,216,1,505
BEL-5_DEU-I,Pao,LTR,27,12,24,11,74
BEL-5_DEU-LTR,Pao,LTR,0,0,0,0,0
BEL-5_DFI-I,Pao,LTR,55,13,35,12,115
BEL-5_DFI-LTR,Pao,LTR,18,9,17,7,51
BEL-5_DMOJ-I,Pao,LTR,46,24,38,16,124
BEL-5_DMOJ-LTR,Pao,LTR,43,10,31,10,94
BEL-5_DPER-I,Pao,LTR,35,20,27,18,100
BEL-5_DPER-LTR,Pao,LTR,0,0,0,0,0
BEL-5_DRH-I,LTR,LTR,107,28,71,21,227
BEL-5_DTA-I,Pao,LTR,1656,10,1076,10,2752
BEL-5_DTA-LTR,Pao,LTR,1,0,0,0,1
BEL-5_DVIR-I,Pao,LTR,216,109,186,102,613
BEL-5_DVIR-LTR,Pao,LTR,0,0,0,0,0
BEL-5_DWIL-I,Pao,LTR,17,7,17,4,45
BEL-5_DWIL-LTR,Pao,LTR,0,0,0,0,0
BEL-5_DYA-I,Pao,LTR,271,101,240,74,686
BEL-5_DYA-LTR:BEL-5_DYA-I,Pao,LTR,51,48,50,41,190
BEL-5_DYA-LTR,Pao,LTR,0,0,0,0,0
BEL-6_DAN-I,Pao,LTR,166,7,112,5,290
BEL-6_DAN-LTR,Pao,LTR,0,0,0,0,0
BEL-6_DBP-I,Pao,LTR,353,50,309,39,751
BEL-6_DBP-LTR,Pao,LTR,0,0,0,0,0
BEL-6_DEL-I,Pao,LTR,79,37,59,31,206
BEL-6_DEL-LTR,Pao,LTR,0,0,0,0,0
BEL-6_DMOJ-I,Pao,LTR,202,38,132,32,404
BEL-6_DMOJ-LTR,Pao,LTR,3,3,3,2,11
BEL-6_DPE-I,Pao,LTR,76,29,64,21,190
BEL-6_DPER-I,Pao,LTR,251,41,114,28,434
BEL-6_DPER-LTR,Pao,LTR,1,1,1,1,4
BEL-6_DRH-I,LTR,LTR,240,143,203,128,714
BEL-6_DRH-LTR,LTR,LTR,7,4,6,4,21
BEL-6_DTA-I,Pao,LTR,37,7,32,6,82
BEL-6_DTA-LTR,Pao,LTR,1,1,1,1,4
BEL-6_DWIL-I,Pao,LTR,1851,15,1349,13,3228
BEL-6_DWIL-LTR,Pao,LTR,3,0,1,0,4
BEL-6_DYA-I:BEL-6_DYA-LTR,Pao,LTR,4380,59,2772,45,7256
BEL-6_DYA-I,Pao,LTR,123728,2098,76372,1627,203825
BEL-6_DYA-LTR:BEL-6_DYA-I:BEL-6_DYA-LTR,Pao,LTR,509,1,347,0,857
BEL-6_DYA-LTR:BEL-6_DYA-I,Pao,LTR,786,14,515,12,1327
BEL-6_DYA-LTR,Pao,LTR,391,10,252,8,661
BEL-7_DAN-I,Pao,LTR,83,12,50,11,156
BEL-7_DAN-LTR,Pao,LTR,2,0,2,0,4
BEL-7_DBP-I,Pao,LTR,63,10,52,5,130
BEL-7_DBP-LTR,Pao,LTR,2,1,2,1,6
BEL-7_DEL-LTR,Pao,LTR,0,0,0,0,0
BEL-7_DMOJ-I,Pao,LTR,30,13,24,10,77
BEL-7_DMOJ-LTR,Pao,LTR,0,0,0,0,0
BEL-7_DPE-I,Pao,LTR,288,40,219,35,582
BEL-7_DPE-LTR,Pao,LTR,0,0,0,0,0
BEL-7_DPER-I,Pao,LTR,96,38,86,31,251
BEL-7_DRH-I,LTR,LTR,151,24,112,22,309
BEL-7_DRH-LTR,LTR,LTR,9,3,8,3,23
BEL-7_DTA-I,Pao,LTR,220,203,216,106,745
BEL-7_DTA-LTR,Pao,LTR,5,2,2,2,11
BEL-7_DWIL-I,Pao,LTR,17,5,15,3,40
BEL-7_DWIL-LTR,Pao,LTR,0,0,0,0,0
BEL-8_DAN-I,Pao,LTR,88,17,49,16,170
BEL-8_DAN-LTR,Pao,LTR,5,5,5,5,20
BEL-8_DBP-I,Pao,LTR,47,15,45,11,118
BEL-8_DBP-LTR,Pao,LTR,0,0,0,0,0
BEL-8_DEL-I,Pao,LTR,127,74,118,68,387
BEL-8_DEL-LTR,Pao,LTR,4,2,4,0,10
BEL-8_DMO-I,Pao,LTR,465,15,310,9,799
BEL-8_DMO-LTR,Pao,LTR,118,106,114,103,441
BEL-8_DPE-I,Pao,LTR,26,11,23,7,67
BEL-8_DPE-LTR,Pao,LTR,12,12,12,10,46
BEL-8_DTA-I,Pao,LTR,43,9,27,5,84
BEL-8_DTA-LTR,Pao,LTR,1,0,1,0,2
BEL-8_DWIL-I,Pao,LTR,61,22,48,18,149
BEL-8_DWIL-LTR,Pao,LTR,1,1,1,1,4
BEL-9_DAN-I,Pao,LTR,110,28,66,24,228
BEL-9_DAN-LTR,Pao,LTR,0,0,0,0,0
BEL-9_DBP-I,Pao,LTR,99,20,58,17,194
BEL-9_DBP-LTR,Pao,LTR,0,0,0,0,0
BEL-9_DEL-I,Pao,LTR,790,10,698,4,1502
BEL-9_DTA-I,Pao,LTR,19,7,16,6,48
BEL-9_DTA-LTR,Pao,LTR,2,2,2,0,6
BEL-9_DWIL-I,Pao,LTR,185,27,122,20,354
BEL-9_DWIL-LTR,Pao,LTR,0,0,0,0,0
BEL_I-INT:BEL_LTR,Pao,LTR,5156,90,3034,66,8346
BEL_I-INT,Pao,LTR,11076,982,6444,879,19381
BEL_LTR:BEL_I-INT:BEL_LTR,Pao,LTR,8266,90,4924,66,13346
BEL_LTR:BEL_I-INT,Pao,LTR,2693,44,1679,36,4452
BEL_LTR,Pao,LTR,1308,31,963,17,2319
BICA_I-INT:BICA_LTR,Gypsy,LTR,879,15,590,7,1491
BICA_I-INT,Gypsy,LTR,3075,137,1927,107,5246
BICA_LTR:BICA_I-INT,Gypsy,LTR,400,12,243,11,666
BICA_LTR,Gypsy,LTR,27,1,21,1,50
BILBO,LOA,LINE,539,10,395,7,951
BLASTOPIA_I-INT:BLASTOPIA_LTR,Gypsy,LTR,350,10,205,8,573
BLASTOPIA_I-INT,Gypsy,LTR,1038,35,725,30,1828
BLASTOPIA_LTR:BLASTOPIA_I-INT:BLASTOPIA_LTR,Gypsy,LTR,1008,11,685,8,1712
BLASTOPIA_LTR:BLASTOPIA_I-INT,Gypsy,LTR,7423,251,4901,229,12804
BLASTOPIA_LTR,Gypsy,LTR,84,15,57,10,166
BLOOD,Gypsy,LTR-Retrotransposon,19074,229,12170,195,31668
BLOOD_I-INT:BLOOD_LTR,Gypsy,LTR,5219,72,3438,52,8781
BLOOD_I-INT,Gypsy,LTR,5261,57,3472,46,8836
BLOOD_LTR:BLOOD_I-INT,Gypsy,LTR,2506,24,1619,22,4171
BLOOD_LTR,Gypsy,LTR,209,21,149,17,396
BS2,Jockey,LINE,88910,1499,66479,1101,157989
BS3_DM,Jockey,LINE,2139,144,1746,106,4135
BS3,Jockey,non-LTR-Retrotransposon,932,79,782,52,1845
BS4_DM,Jockey,LINE,51,27,46,15,139
BS4,Jockey,non-LTR-Retrotransposon,4,1,3,1,9
BS,Jockey,LINE,987,388,891,282,2548
BURDOCK,Gypsy,LTR-Retrotransposon,9387,136,6337,108,15968
BURDOCK_I-INT:BURDOCK_LTR,Gypsy,LTR,5309,80,3912,66,9367
BURDOCK_I-INT,Gypsy,LTR,3315,87,2103,73,5578
BURDOCK_LTR:BURDOCK_I-INT:BURDOCK_LTR,Gypsy,LTR,2014,41,1333,32,3420
BURDOCK_LTR:BURDOCK_I-INT,Gypsy,LTR,2964,34,2367,27,5392
BURDOCK_LTR,Gypsy,LTR,518,8,415,8,949
CHAPAEV3-1_DA,CMC-Chapaev-3,DNA,137,2,118,0,257
CHAPAEV3-1_DW,CMC-Chapaev-3,DNA,45,3,42,2,92
CHIMPO_I-INT:CHIMPO_LTR,Gypsy,LTR,2979,23,2655,16,5673
CHIMPO_I-INT,Gypsy,LTR,16896,135,15356,96,32483
CHIMPO_LTR:CHIMPO_I-INT:CHIMPO_LTR,Gypsy,LTR,5559,42,5114,25,10740
CHIMPO_LTR:CHIMPO_I-INT,Gypsy,LTR,10905,74,10005,45,21029
CHIMPO_LTR,Gypsy,LTR,265,7,212,4,488
CHOUTO_I-INT:CHOUTO_LTR,Gypsy,LTR,3171,72,1795,61,5099
CHOUTO_I-INT,Gypsy,LTR,3310,65,1898,50,5323
CHOUTO_LTR:CHOUTO_I-INT:CHOUTO_LTR,Gypsy,LTR,1720,41,1067,35,2863
CHOUTO_LTR:CHOUTO_I-INT,Gypsy,LTR,2250,28,1265,22,3565
CHOUTO_LTR,Gypsy,LTR,457,110,269,95,931
CIRCE,Gypsy,LTR,57013,1285,44405,1113,103816
COPIA-1_DAN-I,Copia,LTR,73,2,43,1,119
COPIA-1_DAN-LTR,Copia,LTR,37,0,21,0,58
COPIA-1_DBI-I,Copia,LTR,306,41,181,27,555
COPIA-1_DBI-LTR,Copia,LTR,1,0,0,0,1
COPIA-1_DBP-I,Copia,LTR,58,13,28,6,105
COPIA-1_DEL-I,Copia,LTR,83,15,67,14,179
COPIA-1_DEL-LTR,Copia,LTR,0,0,0,0,0
COPIA-1_DEU-I,Copia,LTR,36,5,19,4,64
COPIA-1_DFI-I:COPIA-1_DFI-LTR,Copia,LTR,7,1,4,1,13
COPIA-1_DFI-I,Copia,LTR,158,88,131,69,446
COPIA-1_DFI-LTR,Copia,LTR,3,2,3,2,10
COPIA-1_DGRI-I,Copia,LTR,33,6,31,4,74
COPIA-1_DPER-I,Copia,LTR,983,11,813,8,1815
COPIA-1_DPER-LTR,Copia,LTR,0,0,0,0,0
COPIA-1_DSE-I:COPIA-1_DSE-LTR,Copia,LTR,517,13,313,11,854
COPIA-1_DSE-I,Copia,LTR,977,27,599,21,1624
COPIA-1_DSE-LTR:COPIA-1_DSE-I:COPIA-1_DSE-LTR,Copia,LTR,876,21,499,15,1411
COPIA-1_DSE-LTR:COPIA-1_DSE-I,Copia,LTR,779,7,463,5,1254
COPIA-1_DSE-LTR,Copia,LTR,212,1,129,1,343
COPIA-1_DSIM-I:COPIA-1_DSIM-LTR,Copia,LTR,2954,93,1862,74,4983
COPIA-1_DSIM-I,Copia,LTR,4748,131,3151,100,8130
COPIA-1_DSIM-LTR:COPIA-1_DSIM-I,Copia,LTR,657,21,418,18,1114
COPIA-1_DSIM-LTR,Copia,LTR,88,10,49,8,155
COPIA-1_DTA-I,Copia,LTR,77,19,49,13,158
COPIA-1_DTA-LTR,Copia,LTR,0,0,0,0,0
COPIA-1_DVIR-I,Copia,LTR,215,29,148,26,418
COPIA-1_DVIR-LTR,Copia,LTR,0,0,0,0,0
COPIA-1_DWIL-I,Copia,LTR,36,25,35,18,114
COPIA-1_DWIL-LTR,Copia,LTR,1,1,1,0,3
COPIA-1_DYA-I,Copia,LTR,2729,19,1562,10,4320
COPIA-1_DYA-LTR,Copia,LTR,1,0,0,0,1
COPIA1-I_DM:COPIA1-LTR_DM,Copia,LTR,298,10,175,10,493
COPIA1-I_DM,Copia,LTR,1503,89,1057,84,2733
COPIA1-I_DMOJ,Copia,LTR,39,20,33,9,101
COPIA1-I_DPSE,Copia,LTR,610,52,454,36,1152
COPIA-1-I_DY,Copia,LTR,749,46,603,39,1437
COPIA1-LTR_DM:COPIA1-I_DM:COPIA1-LTR_DM,Copia,LTR,2863,35,2103,33,5034
COPIA1-LTR_DM:COPIA1-I_DM,Copia,LTR,533,6,426,6,971
COPIA1-LTR_DM,Copia,LTR,216,0,155,0,371
COPIA1-LTR_DMOJ,Copia,LTR,0,0,0,0,0
COPIA1-LTR_DPSE,Copia,LTR,3,0,2,0,5
COPIA-1-LTR_DY,Copia,LTR,2,2,2,2,8
COPIA-29_DP-I,Copia,LTR,329,11,151,9,500
COPIA-29_DP-LTR,Copia,LTR,1,0,1,0,2
COPIA-2_DAN-I,Copia,LTR,176,68,149,52,445
COPIA-2_DAN-LTR,Copia,LTR,0,0,0,0,0
COPIA-2_DBP-I,Copia,LTR,38,19,33,17,107
COPIA-2_DBP-LTR,Copia,LTR,0,0,0,0,0
COPIA-2_DEL-I,Copia,LTR,68,12,39,10,129
COPIA-2_DEL-LTR,Copia,LTR,1,0,1,0,2
COPIA-2_DEU-I,Copia,LTR,38,36,38,31,143
COPIA-2_DEU-LTR,Copia,LTR,3,1,1,0,5
COPIA-2_DGRI-I,Copia,LTR,20,10,18,8,56
COPIA-2_DGRI-LTR,Copia,LTR,18,2,11,2,33
COPIA-2_DKI-I,Copia,LTR,16,9,15,7,47
COPIA-2_DPER-I,Copia,LTR,372,47,279,31,729
COPIA-2_DPER-LTR,Copia,LTR,0,0,0,0,0
COPIA-2_DTA-I,Copia,LTR,18,15,18,13,64
COPIA-2_DTA-LTR,Copia,LTR,0,0,0,0,0
COPIA-2_DWIL-I,Copia,LTR,98,8,90,6,202
COPIA-2_DWIL-LTR,Copia,LTR,2,1,1,1,5
COPIA-2_DYA-I,Copia,LTR,2561,81,1412,66,4120
COPIA-2_DYA-LTR,Copia,LTR,323,10,196,6,535
COPIA2-I_DMOJ,Copia,LTR,84,3,29,3,119
COPIA2-I_DPSE,Copia,LTR,26,12,24,7,69
COPIA2_I-INT:COPIA2_LTR_DM,Copia,LTR,544,30,281,21,876
COPIA2_I-INT,Copia,LTR,4135,129,2452,93,6809
COPIA2_LTR_DM:COPIA2_I-INT:COPIA2_LTR_DM,Copia,LTR,499,39,360,24,922
COPIA2_LTR_DM:COPIA2_I-INT,Copia,LTR,54,11,35,8,108
COPIA2_LTR_DM,Copia,LTR,91,13,87,11,202
COPIA2-LTR_DMOJ,Copia,LTR,1,0,1,0,2
COPIA2-LTR_DPSE,Copia,LTR,5,1,4,1,11
COPIA-3_DAN-I,Copia,LTR,305,23,218,22,568
COPIA-3_DAN-LTR,Copia,LTR,0,0,0,0,0
COPIA-3_DBP-I,Copia,LTR,343,110,253,93,799
COPIA-3_DEU-I,Copia,LTR,112,45,106,37,300
COPIA-3_DEU-LTR:COPIA-3_DEU-I,Copia,LTR,13,5,11,3,32
COPIA-3_DEU-LTR,Copia,LTR,2,0,2,0,4
COPIA-3_DGRI-I,Copia,LTR,1261,29,780,19,2089
COPIA-3_DGRI-LTR,Copia,LTR,0,0,0,0,0
COPIA-3_DMOJ-I,Copia,LTR,26,4,20,4,54
COPIA-3_DMOJ-LTR,Copia,LTR,0,0,0,0,0
COPIA-3_DWIL-I,Copia,LTR,176,54,160,44,434
COPIA-3_DWIL-LTR,Copia,LTR,0,0,0,0,0
COPIA-4_DAN-I,Copia,LTR,57,23,47,13,140
COPIA-4_DAN-LTR,Copia,LTR,21,0,19,0,40
COPIA-4_DGRI-I,Copia,LTR,38,10,28,5,81
COPIA-4_DMOJ-I,Copia,LTR,21,7,17,6,51
COPIA-4_DWIL-I,Copia,LTR,57,20,52,16,145
COPIA-4_DWIL-LTR,Copia,LTR,2,0,0,0,2
COPIA-5_DAN-I,Copia,LTR,778,2,500,2,1282
COPIA-5_DAN-LTR,Copia,LTR,1,1,1,0,3
COPIA-5_DWIL-I,Copia,LTR,25,17,24,7,73
COPIA-5_DWIL-LTR,Copia,LTR,0,0,0,0,0
COPIA-6_DAN-I,Copia,LTR,306,3,301,2,612
COPIA-6_DWIL-I,Copia,LTR,25,10,23,5,63
COPIA-6_DWIL-LTR,Copia,LTR,0,0,0,0,0
COPIA-7_DAN-I,Copia,LTR,322,29,226,22,599
COPIA-7_DAN-LTR,Copia,LTR,0,0,0,0,0
COPIA-7_DWIL-I,Copia,LTR,60,32,48,29,169
COPIA-7_DWIL-LTR,Copia,LTR,0,0,0,0,0
COPIA-8_DAN-I,Copia,LTR,141,7,77,4,229
COPIA-8_DAN-LTR,Copia,LTR,14,0,13,0,27
COPIA-8_DWIL-I,Copia,LTR,188,7,135,6,336
COPIA-9_DWIL-I,Copia,LTR,123,11,91,8,233
COPIA-9_DWIL-LTR,Copia,LTR,0,0,0,0,0
COPIA,Copia,LTR-Retrotransposon,2685,161,1612,142,4600
COPIA_I-INT,Copia,LTR,895,112,566,84,1657
COPIA_I-INT:COPIA_LTR,Copia,LTR,858,26,532,20,1436
COPIA_LTR:COPIA_I-INT,Copia,LTR,272,16,177,9,474
COPIA_LTR:COPIA_I-INT:COPIA_LTR,Copia,LTR,896,22,536,21,1475
COPIA_LTR,Copia,LTR,50,4,40,2,96
CR1-10_DTA,CR1,LINE,918,90,654,60,1722
CR1-1_DAN,CR1,LINE,23,12,21,12,68
CR1-1_DBI,CR1,LINE,70,9,37,5,121
CR1-1_DBP,CR1,LINE,16,10,14,9,49
CR1-1_DEL,CR1,LINE,158,118,148,107,531
CR1-1_DEU,CR1,LINE,633,28,500,24,1185
CR1-1_DF,CR1,LINE,359,7,277,2,645
CR1-1_DK,CR1,LINE,187,36,167,30,420
CR1-1_DPER,CR1,LINE,54,39,50,34,177
CR1-1_DRH,CR1,LINE,172,53,141,47,413
CR1-1_DT,CR1,LINE,93,3,41,2,139
CR1-1_DVI,CR1,LINE,67,4,39,3,113
CR1-1_DWIL,CR1,LINE,45,9,29,7,90
CR1-2_DAN,CR1,LINE,116,8,80,4,208
CR1-2_DBI,CR1,LINE,46,19,34,13,112
CR1-2_DBP,CR1,LINE,26,11,23,8,68
CR1-2_DEL,CR1,LINE,63,2,37,2,104
CR1-2_DEU,CR1,LINE,47,10,30,9,96
CR1-2_DF,CR1,LINE,218,56,136,36,446
CR1-2_DK,CR1,LINE,5056,97,2100,41,7294
CR1-2_DPER,CR1,LINE,23,4,18,3,48
CR1-2_DRH,CR1,LINE,582,30,412,25,1049
CR1-2_DT,CR1,LINE,92,11,73,6,182
CR1-2_DWI,CR1,LINE,117,51,91,47,306
CR1-3_DAN,CR1,LINE,23,8,19,7,57
CR1-3_DBI,CR1,LINE,222,68,198,47,535
CR1-3_DBP,CR1,LINE,26,17,22,8,73
CR1-3_DEL,CR1,LINE,74,38,68,21,201
CR1-3_DK,CR1,LINE,140,27,114,18,299
CR1-3_DPER,CR1,LINE,38,23,34,11,106
CR1-3_DT,CR1,LINE,28,11,24,10,73
CR1-3_DWI,CR1,LINE,21,17,18,11,67
CR1-4_DAN,CR1,LINE,35,24,30,15,104
CR1-4_DBI,CR1,LINE,64,16,40,6,126
CR1-4_DEL,CR1,LINE,38,23,33,21,115
CR1-4_DK,CR1,LINE,88,43,83,40,254
CR1-4_DRH,CR1,LINE,40,10,35,9,94
CR1-4_DT,CR1,LINE,72,5,42,5,124
CR1-4_DWI,CR1,LINE,153,49,119,22,343
CR1-5_DEL,CR1,LINE,69,40,50,31,190
CR1-5_DK,CR1,LINE,3,2,2,2,9
CR1-5_DRH,CR1,LINE,27,16,23,12,78
CR1-5_DT,CR1,LINE,26,17,22,10,75
CR1-6_DT,CR1,LINE,19,9,17,6,51
CR1-7_DT,CR1,LINE,79,15,62,10,166
CR1-8_DTA,CR1,LINE,6,5,6,4,21
CR1-9_DTA,CR1,LINE,46,18,37,10,111
CR1A,CR1,non-LTR-Retrotransposon,67887,1888,43804,1496,115075
DBUSCK2CONS,TcMar-Mariner,DNA,1,0,1,0,2
DBUSKI1CONS,TcMar-Mariner,DNA,0,0,0,0,0
DCARDI9,TcMar-Mariner,DNA,59,40,53,40,192
DIVER2,BEL,LTR-Retrotransposon,15462,609,9437,472,25980
DIVER2_I-INT:DIVER2_LTR,Pao,LTR,124,3,79,3,209
DIVER2_I-INT,Pao,LTR,1327,18,793,11,2149
DIVER2_LTR:DIVER2_I-INT,Pao,LTR,162,3,124,3,292
DIVER2_LTR,Pao,LTR,17559,248,12385,193,30385
DIVER,BEL,LTR-Retrotransposon,3473,111,1811,95,5490
DIVER_I-INT:DIVER_LTR,Pao,LTR,2186,44,1220,36,3486
DIVER_I-INT,Pao,LTR,3501,87,1993,70,5651
DIVER_LTR:DIVER_I-INT:DIVER_LTR,Pao,LTR,1906,56,993,47,3002
DIVER_LTR:DIVER_I-INT,Pao,LTR,1364,50,809,40,2263
DIVER_LTR,Pao,LTR,114,34,71,31,250
DM1731_I-INT,Copia,LTR,2330,113,1065,67,3575
DM1731_I-INT:DM1731_LTR,Copia,LTR,466,11,240,7,724
DM1731_LTR,Copia,LTR,238,5,100,5,348
DM1731_LTR:DM1731_I-INT,Copia,LTR,2246,66,1111,58,3481
DM1731_LTR:DM1731_I-INT:DM1731_LTR,Copia,LTR,1882,45,808,34,2769
DM176_I-INT:DM176_LTR,Gypsy,LTR,47,9,23,6,85
DM176_I-INT,Gypsy,LTR,1499,59,989,48,2595
DM176_LTR:DM176_I-INT,Gypsy,LTR,79,25,57,22,183
DM176_LTR,Gypsy,LTR,485,101,357,67,1010
DM297_I-INT:DM297_LTR,Gypsy,LTR,4331,92,3332,82,7837
DM297_I-INT,Gypsy,LTR,26790,405,19429,331,46955
DM297_LTR:DM297_I-INT:DM297_LTR,Gypsy,LTR,5804,50,4202,36,10092
DM297_LTR:DM297_I-INT,Gypsy,LTR,11556,121,8876,91,20644
DM297_LTR,Gypsy,LTR,2423,69,1865,54,4411
DM412B_LTR:DM412:DM412B_LTR,Gypsy,LTR,2373,5,1816,5,4199
DM412B_LTR:DM412,Gypsy,LTR,15561,108,10270,93,26032
DM412B_LTR,Gypsy,LTR,6105,69,4117,49,10340
DM412:DM412B_LTR,Gypsy,LTR,24250,156,15838,110,40354
DM412,Gypsy,LTR,58810,508,38701,401,98420
DM88,Copia,LTR-Retrotransposon,3489,215,2225,169,6098
DMACUL5,TcMar-Mariner,DNA,4,0,2,0,6
DMCR1A,CR1,LINE,176533,4221,128381,2986,312121
DMEDPU1CONS,TcMar-Mariner,DNA,2,2,2,1,7
DMEDPU27,TcMar-Mariner,DNA,38,0,26,0,64
DMEDTR1CONS,TcMar-Mariner,DNA,0,0,0,0,0
DMLTR5,Gypsy,LTR,1272,73,712,47,2104
DMRT1A,R1,LINE,18750,398,14772,287,34207
DMRT1B,R1,LINE,144050,2290,105714,1868,253922
DMRT1C,R1,LINE,89997,2872,65606,2414,160889
DMTOM1_LTR,Gypsy,LTR,2289,73,1320,63,3745
DNA-1_DBP,DNA,DNA,1,0,1,0,2
DNA-1_DEU,DNA,DNA,5,0,5,0,10
DNA-1_DPE,DNA,DNA,3,3,3,2,11
DNA2-1_DAN,DNA,DNA,13286,186,8759,107,22338
DNA-2_DBP,DNA,DNA,0,0,0,0,0
DNA3-1_DF,DNA,DNA,272,100,214,79,665
DNA3-1_DTA,DNA,DNA,0,0,0,0,0
DNA3-2_DTA,DNA,DNA,5,2,3,2,12
DNA7-1_DEL,P,DNA,1,1,1,1,4
DNA8-1_DEL,DNA,DNA,62,10,48,6,126
DNAREP1_DM,RC,DNA,12108,2314,8499,1900,24821
DNAREP1_DSIM,RC,DNA,22305,2454,14290,1943,40992
DNAREP1_DYAK,RC,DNA,3702,830,2636,670,7838
DNAREP2_DSIM,RC,DNA,2290,693,1632,610,5225
DNA-TA-1_DF,TcMar,DNA,0,0,0,0,0
DNA-TA-1_DTA,DNA,DNA,2,0,0,0,2
DNEOCA19,TcMar-Mariner,DNA,5,1,3,0,9
DNEOCA1CONS,TcMar-Mariner,DNA,12,4,6,3,25
DNEOCA1,TcMar-Mariner,DNA,0,0,0,0,0
DOC2_DM,Jockey,LINE,63773,1106,39868,966,105713
DOC2,Jockey,non-LTR-Retrotransposon,3056,40,1930,33,5059
DOC3_DM,Jockey,LINE,23568,810,12780,638,37796
DOC3,Jockey,non-LTR-Retrotransposon,1285,88,779,61,2213
DOC4_DM,Jockey,LINE,6867,82,3925,70,10944
DOC5_DM,Jockey,LINE,12725,281,6786,227,20019
DOC6_DM,Jockey,LINE,3447,55,2145,42,5689
DOC,Jockey,LINE,17972,483,9211,373,28039
DORNA1CONS,TcMar-Mariner,DNA,7,5,5,5,22
DPALLI7,TcMar-Mariner,DNA,0,0,0,0,0
DPARAG19,TcMar-Mariner,DNA,0,0,0,0,0
DPARAG30,TcMar-Mariner,DNA,1,0,1,0,2
DPARAM1CONS,TcMar-Mariner,DNA,0,0,0,0,0
DPARAM2CONS,TcMar-Mariner,DNA,0,0,0,0,0
DTRIPU1CONS,TcMar-Mariner,DNA,0,0,0,0,0
DTRIPU2CONS,TcMar-Mariner,DNA,0,0,0,0,0
ENSPM-1_DF,CMC-Chapaev-3,DNA,344,65,250,46,705
FB4_DM,TcMar-Tc1,DNA,16288,539,8527,351,25705
FB,Mariner/Tc1,DNA-transposon,3202,319,2341,241,6103
F-ELEMENT,Jockey,non-LTR-Retrotransposon,18271,414,11808,308,30801
FLEA,-,LTR-Retrotransposon,12075,265,8413,231,20984
FROGGER,Copia,LTR-Retrotransposon,562,25,357,21,965
FROGGER_I-INT,Copia,LTR,11,4,9,4,28
FROGGER_I-INT:FROGGER_LTR,Copia,LTR,72,6,57,6,141
FROGGER_LTR,Copia,LTR,14,0,12,0,26
FROGGER_LTR:FROGGER_I-INT,Copia,LTR,78,23,50,19,170
FW2_DM,Jockey,LINE,2717,156,1767,118,4758
FW2,Jockey,non-LTR-Retrotransposon,6746,193,2722,140,9801
FW3_DM,Jockey,LINE,313,160,263,136,872
FW3,Jockey,non-LTR-Retrotransposon,63,24,54,17,158
FW_DM,Jockey,LINE,20050,768,12704,610,34132
G2_DM,Jockey,LINE,23023,356,19368,290,43037
G2,Jockey,non-LTR-Retrotransposon,2222,74,1787,54,4137
G3_DM,Jockey,LINE,157,41,122,34,354
G3,Jockey,non-LTR-Retrotransposon,1715,137,1275,103,3230
G4_DM,Jockey,LINE,3272,50,1953,38,5313
G4,Jockey,non-LTR-Retrotransposon,2423,118,1473,85,4099
G5A_DM,Jockey,LINE,9734,316,6661,215,16926
G5A,Jockey,non-LTR-Retrotransposon,33429,226,25560,183,59398
G5_DM,Jockey,LINE,49893,711,34437,528,85569
G5,Jockey,non-LTR-Retrotransposon,4377,280,3429,241,8327
G6_DM,Jockey,LINE,8380,415,5367,287,14449
G6,Jockey,non-LTR-Retrotransposon,1822,51,971,39,2883
G7_DM,Jockey,LINE,17,7,14,5,43
G7,Jockey,non-LTR-Retrotransposon,33,22,31,18,104
GALILEO_DB,P,DNA,55,23,46,19,143
GALILEO_DM,P,DNA,1135,206,748,147,2236
GALILEO_DW,P,DNA,23,6,17,3,49
GATE,BEL,LTR-Retrotransposon,17494,232,11441,174,29341
G_DM,Jockey,LINE,1498,141,1239,107,2985
G-ELEMENT,Jockey,non-LTR-Retrotransposon,819,163,591,122,1695
GTWIN,Gypsy,LTR-Retrotransposon,4615,86,2937,56,7694
GTWIN_I-INT:GTWIN_LTR,Gypsy,LTR,12317,165,7847,133,20462
GTWIN_I-INT,Gypsy,LTR,30657,531,23328,409,54925
GTWIN_LTR:GTWIN_I-INT,Gypsy,LTR,9893,116,9163,104,19276
GTWIN_LTR,Gypsy,LTR,3608,23,2494,19,6144
GYPSY-10_DAN-I,Gypsy,LTR,79,20,64,11,174
GYPSY-10_DAN-LTR,Gypsy,LTR,437,0,419,0,856
GYPSY-10_DBP-I,LTR,LTR,1502,65,907,54,2528
GYPSY-10_DEL-I,Gypsy,LTR,23,20,21,17,81
GYPSY-10_DEL-LTR,Gypsy,LTR,9,8,8,3,28
GYPSY-10_DEU-I,Gypsy,LTR,870,89,578,75,1612
GYPSY-10_DFI-I,Gypsy,LTR,80,11,70,7,168
GYPSY-10_DFI-LTR,Gypsy,LTR,2,2,2,2,8
GYPSY-10_DMOJ-I,LTR,LTR,1081,51,802,43,1977
GYPSY-10_DMOJ-LTR,Gypsy,LTR,3125,157,1915,134,5331
GYPSY-10_DPER-I,Gypsy,LTR,117,10,67,5,199
GYPSY-10_DPER-LTR,Gypsy,LTR,1,0,1,0,2
GYPSY-10_DRH-I,LTR,LTR,24,17,23,10,74
GYPSY-10_DRH-LTR,LTR,LTR,8,5,8,3,24
GYPSY-10_DSIM-I,Gypsy,LTR,10268,554,5158,482,16462
GYPSY-10_DTA-I,Gypsy,LTR,347,74,300,47,768
GYPSY-10_DTA-LTR,Gypsy,LTR,3,1,2,1,7
GYPSY-10_DVIR-I,Gypsy,LTR,323,190,284,174,971
GYPSY-10_DVIR-LTR,Gypsy,LTR,95,43,85,35,258
GYPSY-10_DWIL-I,Gypsy,LTR,23,12,18,9,62
GYPSY-10_DWIL-LTR,Gypsy,LTR,0,0,0,0,0
GYPSY10,Gypsy,LTR-Retrotransposon,1475,94,873,70,2512
GYPSY10-I_DPSE,Gypsy,LTR,826,10,712,9,1557
GYPSY10-I_DYA:GYPSY10-LTR_DYA,Gypsy,LTR,7,2,5,1,15
GYPSY10-I_DYA,Gypsy,LTR,352,63,297,49,761
GYPSY10_I-INT:GYPSY10_LTR,Gypsy,LTR,1245,60,550,50,1905
GYPSY10_I-INT,Gypsy,LTR,2966,130,1574,96,4766
GYPSY10-LTR_DPSE,Gypsy,LTR,11,1,3,0,15
GYPSY10-LTR_DYA:GYPSY10-I_DYA,Gypsy,LTR,24,17,23,15,79
GYPSY10-LTR_DYA,Gypsy,LTR,18,6,10,3,37
GYPSY10_LTR:GYPSY10_I-INT,Gypsy,LTR,7772,91,3889,58,11810
GYPSY10_LTR,Gypsy,LTR,106,5,55,2,168
GYPSY-11_DAN-I,Gypsy,LTR,166,23,109,18,316
GYPSY-11_DAN-LTR,Gypsy,LTR,1033,785,961,774,3553
GYPSY-11_DBI-I,LTR,LTR,1062,22,385,12,1481
GYPSY-11_DBP-I,Gypsy,LTR,2902,54,2339,39,5334
GYPSY-11_DEL-I,Gypsy,LTR,124,18,84,14,240
GYPSY-11_DEU-I,Gypsy,LTR,20,15,19,12,66
GYPSY-11_DEU-LTR,Gypsy,LTR,0,0,0,0,0
GYPSY-11_DFI-I:GYPSY-11_DFI-LTR,Gypsy,LTR,11,8,11,7,37
GYPSY-11_DFI-I,Gypsy,LTR,199,42,134,34,409
GYPSY-11_DFI-LTR,Gypsy,LTR,0,0,0,0,0
GYPSY-11_DPER-I,Gypsy,LTR,90,19,53,15,177
GYPSY-11_DPER-LTR,Gypsy,LTR,22,3,13,3,41
GYPSY-11_DRH-I,LTR,LTR,1188,23,1063,21,2295
GYPSY-11_DRH-LTR,LTR,LTR,23,7,21,4,55
GYPSY-11_DSIM-I:GYPSY-11_DSIM-LTR,Gypsy,LTR,5343,64,3125,49,8581
GYPSY-11_DSIM-I,Gypsy,LTR,68700,1388,42476,1139,113703
GYPSY-11_DSIM-LTR:GYPSY-11_DSIM-I:GYPSY-11_DSIM-LTR,Gypsy,LTR,3329,38,1986,30,5383
GYPSY-11_DSIM-LTR:GYPSY-11_DSIM-I,Gypsy,LTR,2457,33,1390,25,3905
GYPSY-11_DSIM-LTR,Gypsy,LTR,1128,20,615,16,1779
GYPSY-11_DTA-I,Gypsy,LTR,174,23,106,19,322
GYPSY-11_DTA-LTR,Gypsy,LTR,90,2,20,2,114
GYPSY-11_DVIR-I,Gypsy,LTR,1685,44,1204,35,2968
GYPSY-11_DVIR-LTR,Gypsy,LTR,56,51,53,30,190
GYPSY-11_DWIL-I,Gypsy,LTR,16,2,16,2,36
GYPSY-11_DWIL-LTR,Gypsy,LTR,1,0,0,0,1
GYPSY11,Gypsy,LTR-Retrotransposon,304,32,225,27,588
GYPSY11-I_DPSE,Gypsy,LTR,93,49,81,33,256
GYPSY11-I_DYA,Gypsy,LTR,2321,753,1726,669,5469
GYPSY11_I-INT:GYPSY11_LTR,Gypsy,LTR,138,7,101,5,251
GYPSY11_I-INT,Gypsy,LTR,1768,110,1365,77,3320
GYPSY11-LTR_DPSE,Gypsy,LTR,1,1,1,1,4
GYPSY11-LTR_DYA:GYPSY11-I_DYA,Gypsy,LTR,39,8,29,8,84
GYPSY11-LTR_DYA,Gypsy,LTR,2,2,2,1,7
GYPSY11_LTR:GYPSY11_I-INT,Gypsy,LTR,171,44,118,35,368
GYPSY11_LTR,Gypsy,LTR,75,19,62,16,172
GYPSY12A_LTR:GYPSY12_I-INT:GYPSY12_LTR,Gypsy,LTR,1643,41,825,34,2543
GYPSY12A_LTR:GYPSY12_I-INT,Gypsy,LTR,162,15,125,12,314
GYPSY12A_LTR:GYPSY12_LTR,Gypsy,LTR,75,5,41,3,124
GYPSY12A_LTR,Gypsy,LTR,2713,422,1975,352,5462
GYPSY-12_DAN-I,Gypsy,LTR,54,10,36,10,110
GYPSY-12_DAN-LTR:GYPSY-12_DAN-I:GYPSY-12_DAN-LTR,Gypsy,LTR,1,0,0,0,1
GYPSY-12_DAN-LTR:GYPSY-12_DAN-I,Gypsy,LTR,2,0,1,0,3
GYPSY-12_DAN-LTR,Gypsy,LTR,164,0,134,0,298
GYPSY-12_DBP-I,Gypsy,LTR,17,6,14,6,43
GYPSY-12_DBP-LTR,Gypsy,LTR,1,0,1,0,2
GYPSY-12_DEL-I,Gypsy,LTR,44,11,39,10,104
GYPSY-12_DEL-LTR,Gypsy,LTR,0,0,0,0,0
GYPSY-12_DEU-I,Gypsy,LTR,39,12,32,9,92
GYPSY-12_DEU-LTR,Gypsy,LTR,1,1,1,0,3
GYPSY-12_DFI-I,Gypsy,LTR,951,154,572,126,1803
GYPSY-12_DFI-LTR,Gypsy,LTR,4,0,3,0,7
GYPSY-12_DPER-I,Gypsy,LTR,62,19,51,8,140
GYPSY-12_DPER-LTR,Gypsy,LTR,1,1,1,0,3
GYPSY-12_DRH-I:GYPSY-12_DRH-LTR,LTR,LTR,5,4,5,2,16
GYPSY-12_DRH-I,LTR,LTR,64,22,58,14,158
GYPSY-12_DRH-LTR:GYPSY-12_DRH-I,LTR,LTR,15,5,12,4,36
GYPSY-12_DRH-LTR,LTR,LTR,173,81,160,66,480
GYPSY-12_DSIM-I:GYPSY-12_DSIM-LTR,Gypsy,LTR,2181,88,1433,78,3780
GYPSY-12_DSIM-I,Gypsy,LTR,9409,771,6101,661,16942
GYPSY-12_DSIM-LTR:GYPSY-12_DSIM-I,Gypsy,LTR,1599,44,1053,38,2734
GYPSY-12_DSIM-LTR,Gypsy,LTR,1409,97,892,78,2476
GYPSY-12_DTA-I,Gypsy,LTR,2009,43,1173,35,3260
GYPSY-12_DTA-LTR:GYPSY-12_DTA-I,Gypsy,LTR,17,6,15,6,44
GYPSY-12_DTA-LTR,Gypsy,LTR,128,6,104,5,243
GYPSY-12_DVIR-I,Gypsy,LTR,99,29,74,14,216
GYPSY-12_DVIR-LTR,Gypsy,LTR,13,7,13,2,35
GYPSY-12_DWIL-I,Gypsy,LTR,183,36,119,29,367
GYPSY-12_DWIL-LTR,Gypsy,LTR,0,0,0,0,0
GYPSY12,Gypsy,LTR-Retrotransposon,36800,484,28114,363,65761
GYPSY12-I_DPSE,Gypsy,LTR,1077,145,816,132,2170
GYPSY12-I_DYA:GYPSY12-LTR_DYA,Gypsy,LTR,234,36,145,20,435
GYPSY12-I_DYA,Gypsy,LTR,48,27,43,19,137
GYPSY12_I-INT:GYPSY12A_LTR,Gypsy,LTR,4195,86,3215,59,7555
GYPSY12_I-INT:GYPSY12_LTR,Gypsy,LTR,20232,124,16741,90,37187
GYPSY12_I-INT,Gypsy,LTR,11820,282,7853,200,20155
GYPSY12-LTR_DPSE,Gypsy,LTR,3,2,3,1,9
GYPSY12-LTR_DYA:GYPSY12-I_DYA,Gypsy,LTR,37,20,32,17,106
GYPSY12-LTR_DYA,Gypsy,LTR,9,5,9,3,26
GYPSY12_LTR:GYPSY12_I-INT:GYPSY12_LTR,Gypsy,LTR,2496,68,2006,48,4618
GYPSY12_LTR:GYPSY12_I-INT,Gypsy,LTR,977,48,658,35,1718
GYPSY12_LTR,Gypsy,LTR,15434,208,11438,151,27231
GYPSY-13_DAN-I,Gypsy,LTR,177,17,116,16,326
GYPSY-13_DAN-LTR,Gypsy,LTR,1,0,1,0,2
GYPSY-13_DBI-I,Gypsy,LTR,53,32,49,28,162
GYPSY-13_DBI-LTR,Gypsy,LTR,0,0,0,0,0
GYPSY-13_DBP-I,Gypsy,LTR,154,9,96,7,266
GYPSY-13_DBP-LTR,Gypsy,LTR,4,3,4,3,14
GYPSY-13_DEL-I,Gypsy,LTR,301,3,231,1,536
GYPSY-13_DEL-LTR,Gypsy,LTR,0,0,0,0,0
GYPSY-13_DEU-I,Gypsy,LTR,166,67,137,56,426
GYPSY-13_DEU-LTR,Gypsy,LTR,17,12,14,10,53
GYPSY-13_DFI-I,Gypsy,LTR,69,13,61,11,154
GYPSY-13_DFI-LTR,Gypsy,LTR,0,0,0,0,0
GYPSY-13_DRH-I,LTR,LTR,1875,90,1117,63,3145
GYPSY-13_DRH-LTR,LTR,LTR,30,9,20,8,67
GYPSY-13_DSIM-I:GYPSY-13_DSIM-LTR,Gypsy,LTR,40260,484,29950,357,71051
GYPSY-13_DSIM-I,Gypsy,LTR,102470,1185,73807,816,178278
GYPSY-13_DSIM-LTR:GYPSY-13_DSIM-I:GYPSY-13_DSIM-LTR,Gypsy,LTR,5595,46,4399,25,10065
GYPSY-13_DSIM-LTR:GYPSY-13_DSIM-I,Gypsy,LTR,32131,281,23420,198,56030
GYPSY-13_DSIM-LTR,Gypsy,LTR,32503,750,23724,535,57512
GYPSY-13_DTA-I,Gypsy,LTR,87,25,75,20,207
GYPSY-13_DTA-LTR,Gypsy,LTR,0,0,0,0,0
GYPSY-13_DVIR-I,Gypsy,LTR,89,37,74,33,233
GYPSY-13_DVIR-LTR,Gypsy,LTR,1,0,1,0,2
GYPSY-13_DWIL-I,Gypsy,LTR,120,11,88,8,227
GYPSY-13_DWIL-LTR,Gypsy,LTR,0,0,0,0,0
GYPSY13-I_DPSE,Gypsy,LTR,488,64,282,49,883
GYPSY13-I_DYA:GYPSY13-LTR_DYA,Gypsy,LTR,49,18,36,13,116
GYPSY13-I_DYA,Gypsy,LTR,262,33,219,24,538
GYPSY13-LTR_DPSE,Gypsy,LTR,1,0,1,0,2
GYPSY13-LTR_DYA:GYPSY13-I_DYA,Gypsy,LTR,7,1,4,1,13
GYPSY13-LTR_DYA,Gypsy,LTR,52,19,39,16,126
GYPSY-14B_DWIL-I,Gypsy,LTR,29,13,26,8,76
GYPSY-14B_DWIL-LTR,Gypsy,LTR,2,2,2,2,8
GYPSY-14_DAN-I,Gypsy,LTR,3603,425,2472,311,6811
GYPSY-14_DAN-LTR:GYPSY-14_DAN-I,Gypsy,LTR,5,1,3,1,10
GYPSY-14_DAN-LTR,Gypsy,LTR,0,0,0,0,0
GYPSY-14_DBI-I,Gypsy,LTR,31,13,26,13,83
GYPSY-14_DBI-LTR,Gypsy,LTR,3,3,3,3,12
GYPSY-14_DBP-I,Gypsy,LTR,85,8,32,6,131
GYPSY-14_DBP-LTR,Gypsy,LTR,0,0,0,0,0
GYPSY-14_DEL-I,Gypsy,LTR,1124,4,713,4,1845
GYPSY-14_DEL-LTR,Gypsy,LTR,2,1,2,1,6
GYPSY-14_DEU-I,Gypsy,LTR,177,13,115,9,314
GYPSY-14_DEU-LTR,Gypsy,LTR,5,4,5,4,18
GYPSY-14_DFI-I,Gypsy,LTR,270,217,253,210,950
GYPSY-14_DFI-LTR,Gypsy,LTR,4,1,2,1,8
GYPSY-14_DRH-I,LTR,LTR,22,17,21,15,75
GYPSY-14_DRH-LTR,LTR,LTR,11,4,9,2,26
GYPSY-14_DTA-I,Gypsy,LTR,66,17,48,14,145
GYPSY-14_DTA-LTR,Gypsy,LTR,1,1,1,1,4
GYPSY-14_DWIL-I,Gypsy,LTR,1571,27,1245,22,2865
GYPSY-14_DWIL-LTR,Gypsy,LTR,1,1,1,1,4
GYPSY14-I_DPSE,Gypsy,LTR,3,2,3,2,10
GYPSY14-I_DYA,Gypsy,LTR,61,35,58,27,181
GYPSY14-LTR_DPSE,Gypsy,LTR,121,54,111,47,333
GYPSY14-LTR_DYA,Gypsy,LTR,0,0,0,0,0
GYPSY-15_DAN-I,Gypsy,LTR,80,3,52,3,138
GYPSY-15_DAN-LTR,Gypsy,LTR,5,3,4,3,15
GYPSY-15_DBI-I,Gypsy,LTR,271,33,104,31,439
GYPSY-15_DBI-LTR,Gypsy,LTR,3,3,3,3,12
GYPSY-15_DBP-I,Gypsy,LTR,46,25,35,17,123
GYPSY-15_DBP-LTR,Gypsy,LTR,30,0,16,0,46
GYPSY-15_DEL-I:GYPSY-15_DEL-LTR,Gypsy,LTR,8,5,7,5,25
GYPSY-15_DEL-I,Gypsy,LTR,160,59,129,55,403
GYPSY-15_DEL-LTR:GYPSY-15_DEL-I,Gypsy,LTR,61,13,45,11,130
GYPSY-15_DEL-LTR,Gypsy,LTR,1738,85,1224,46,3093
GYPSY-15_DFI-LTR,Gypsy,LTR,14,5,9,5,33
GYPSY-15_DRH-I,LTR,LTR,5749,131,4532,102,10514
GYPSY-15_DRH-LTR,LTR,LTR,1401,36,972,25,2434
GYPSY-15_DTA-I,Gypsy,LTR,341,43,247,24,655
GYPSY-15_DTA-LTR,Gypsy,LTR,0,0,0,0,0
GYPSY-15_DWIL-I,Gypsy,LTR,207,16,160,10,393
GYPSY-15_DWIL-LTR,Gypsy,LTR,4,0,4,0,8
GYPSY15-I_DPSE,Gypsy,LTR,94,60,85,22,261
GYPSY15-I_DYA:GYPSY15-LTR_DYA,Gypsy,LTR,17,5,11,3,36
GYPSY15-I_DYA,Gypsy,LTR,6248,1218,4819,1147,13432
GYPSY15-LTR_DPSE,Gypsy,LTR,25,21,24,18,88
GYPSY15-LTR_DYA:GYPSY15-I_DYA:GYPSY15-LTR_DYA,Gypsy,LTR,9,9,9,9,36
GYPSY15-LTR_DYA,Gypsy,LTR,7,0,4,0,11
GYPSY-16_DAN-I,Gypsy,LTR,110,65,90,54,319
GYPSY-16_DBI-I,Gypsy,LTR,177,77,141,58,453
GYPSY-16_DBI-LTR,Gypsy,LTR,0,0,0,0,0
GYPSY-16_DBP-I,Gypsy,LTR,575,472,537,454,2038
GYPSY-16_DEL-I,Gypsy,LTR,76,8,57,6,147
GYPSY-16_DEL-LTR,Gypsy,LTR,1,0,1,0,2
GYPSY-16_DRH-I,LTR,LTR,1005,59,565,51,1680
GYPSY-16_DRH-LTR,LTR,LTR,0,0,0,0,0
GYPSY-16_DTA-I,Gypsy,LTR,27,19,25,9,80
GYPSY-16_DWIL-I,Gypsy,LTR,5,3,5,2,15
GYPSY-16_DWIL-LTR,Gypsy,LTR,0,0,0,0,0
GYPSY16-I_DPSE,Gypsy,LTR,169,23,106,19,317
GYPSY16-I_DYA:GYPSY16-LTR_DYA,Gypsy,LTR,15,4,9,2,30
GYPSY16-I_DYA,Gypsy,LTR,834,218,586,113,1751
GYPSY16-LTR_DPSE,Gypsy,LTR,1,1,1,1,4
GYPSY16-LTR_DYA:GYPSY16-I_DYA,Gypsy,LTR,41,9,37,8,95
GYPSY16-LTR_DYA,Gypsy,LTR,64,8,44,6,122
GYPSY-17_DAN-I,Gypsy,LTR,50,23,43,15,131
GYPSY-17_DAN-LTR,Gypsy,LTR,5,2,4,1,12
GYPSY-17_DBI-I,Gypsy,LTR,94,5,57,3,159
GYPSY-17_DBI-LTR,Gypsy,LTR,6,2,4,1,13
GYPSY-17_DBP-I,Gypsy,LTR,23,14,21,13,71
GYPSY-17_DBP-LTR,Gypsy,LTR,15,11,13,11,50
GYPSY-17_DEL-I,Gypsy,LTR,87,51,69,33,240
GYPSY-17_DEL-LTR,Gypsy,LTR,1,0,1,0,2
GYPSY-17_DRH-I,LTR,LTR,911,99,769,74,1853
GYPSY-17_DRH-LTR,LTR,LTR,4,1,4,1,10
GYPSY-17_DTA-I:GYPSY-17_DTA-LTR,Gypsy,LTR,2,1,1,1,5
GYPSY-17_DTA-I,Gypsy,LTR,586,127,407,93,1213
GYPSY-17_DTA-LTR,Gypsy,LTR,31,0,23,0,54
GYPSY-17_DWIL-I,Gypsy,LTR,96,13,69,8,186
GYPSY17-I_DPSE,Gypsy,LTR,169,17,132,12,330
GYPSY17-I_DYA,Gypsy,LTR,168,36,106,28,338
GYPSY17-LTR_DPSE,Gypsy,LTR,0,0,0,0,0
GYPSY-18_DAN-I,LTR,LTR,305,9,257,5,576
GYPSY-18_DBP-I,Gypsy,LTR,233,26,180,18,457
GYPSY-18_DEL-I,Gypsy,LTR,583,62,443,50,1138
GYPSY-18_DEL-LTR,Gypsy,LTR,7,3,7,2,19
GYPSY-18_DTA-I,Gypsy,LTR,36,16,26,13,91
GYPSY-18_DTA-LTR,Gypsy,LTR,71,8,56,7,142
GYPSY-18_DWIL-I,Gypsy,LTR,114,26,85,20,245
GYPSY-18_DWIL-LTR,Gypsy,LTR,1270,528,927,479,3204
GYPSY18-I_DPSE,Gypsy,LTR,33,23,33,17,106
GYPSY18-I_DYA,Gypsy,LTR,419,139,348,125,1031
GYPSY18-LTR_DPSE,Gypsy,LTR,0,0,0,0,0
GYPSY18-LTR_DYA,Gypsy,LTR,1,1,1,0,3
GYPSY-19_DAN-I,Gypsy,LTR,427,20,340,14,801
GYPSY-19_DAN-LTR,Gypsy,LTR,36,27,33,26,122
GYPSY-19_DBP-I,Gypsy,LTR,21,12,18,10,61
GYPSY-19_DBP-LTR,Gypsy,LTR,0,0,0,0,0
GYPSY-19_DEL-I,Gypsy,LTR,197,9,94,7,307
GYPSY-19_DEL-LTR,Gypsy,LTR,5,5,5,2,17
GYPSY-19_DTA-I,Gypsy,LTR,76,25,62,22,185
GYPSY-19_DWIL-I,Gypsy,LTR,515,42,351,34,942
GYPSY-19_DWIL-LTR,Gypsy,LTR,141,1,86,1,229
GYPSY19-I_DPSE,Gypsy,LTR,344,18,160,18,540
GYPSY19-I_DYA,Gypsy,LTR,111,68,100,58,337
GYPSY19-LTR_DPSE,Gypsy,LTR,1,0,1,0,2
GYPSY19-LTR_DYA,Gypsy,LTR,8,5,7,5,25
GYPSY-1A_DPER-LTR,Gypsy,LTR,0,0,0,0,0
GYPSY-1_DAN-I,Gypsy,LTR,180,56,132,43,411
GYPSY-1_DAN-LTR,LTR,LTR,1,0,1,0,2
GYPSY-1_DBI-I,Gypsy,LTR,549,17,464,12,1042
GYPSY-1_DBI-LTR,LTR,LTR,5,1,2,1,9
GYPSY-1_DBP-I,Gypsy,LTR,533,193,431,177,1334
GYPSY-1_DBP-LTR,Gypsy,LTR,0,0,0,0,0
GYPSY-1_DEL-I,Gypsy,LTR,33,13,24,12,82
GYPSY-1_DEL-LTR,Gypsy,LTR,1,0,1,0,2
GYPSY-1_DEU-I,Gypsy,LTR,42,28,37,23,130
GYPSY-1_DEU-LTR,Gypsy,LTR,0,0,0,0,0
GYPSY-1_DFI-I,Gypsy,LTR,145,60,121,52,378
GYPSY-1_DFI-LTR,Gypsy,LTR,39,2,25,1,67
GYPSY-1_DG-I,Gypsy,LTR,630,70,488,55,1243
GYPSY-1_DG-LTR:GYPSY-1_DG-I,Gypsy,LTR,1,0,1,0,2
GYPSY-1_DG-LTR,Gypsy,LTR,22,3,20,2,47
GYPSY-1_DGRI-I,Gypsy,LTR,53,7,27,6,93
GYPSY-1_DGRI-LTR,Gypsy,LTR,29,3,19,1,52
GYPSY-1_DKI-I,Gypsy,LTR,81,9,53,8,151
GYPSY-1_DKI-LTR,Gypsy,LTR,5,5,5,3,18
GYPSY-1_DPER-I,Gypsy,LTR,132,26,121,21,300
GYPSY-1_DPER-LTR,Gypsy,LTR,3,3,3,3,12
GYPSY-1_DRH-I:GYPSY-1_DRH-LTR,LTR,LTR,4,0,2,0,6
GYPSY-1_DRH-I,LTR,LTR,57,8,43,3,111
GYPSY-1_DRH-LTR,LTR,LTR,4,2,4,2,12
GYPSY-1_DSE-I:GYPSY-1_DSE-LTR,Gypsy,LTR,7615,245,4384,199,12443
GYPSY-1_DSE-I,Gypsy,LTR,36223,7505,24332,7167,75227
GYPSY-1_DSE-LTR:GYPSY-1_DSE-I:GYPSY-1_DSE-LTR,Gypsy,LTR,41,1,25,1,68
GYPSY-1_DSE-LTR:GYPSY-1_DSE-I,Gypsy,LTR,1969,24,1128,19,3140
GYPSY-1_DSE-LTR,Gypsy,LTR,189,5,132,4,330
GYPSY-1_DSIM-I:GYPSY-1_DSIM-LTR,Gypsy,LTR,14191,551,9015,484,24241
GYPSY-1_DSIM-I,Gypsy,LTR,53886,1484,34474,1195,91039
GYPSY-1_DSIM-LTR:GYPSY-1_DSIM-I:GYPSY-1_DSIM-LTR,Gypsy,LTR,4252,77,2610,58,6997
GYPSY-1_DSIM-LTR:GYPSY-1_DSIM-I,Gypsy,LTR,10911,818,7262,727,19718
GYPSY-1_DSIM-LTR,Gypsy,LTR,86,5,52,5,148
GYPSY-1_DTA-I,Gypsy,LTR,27,0,13,0,40
GYPSY-1_DTA-LTR,Gypsy,LTR,6,1,3,1,11
GYPSY-1_DVIR-I,Gypsy,LTR,1664,38,1062,35,2799
GYPSY-1_DVIR-LTR,Gypsy,LTR,82,3,69,1,155
GYPSY-1_DWIL-I,Gypsy,LTR,119,4,88,3,214
GYPSY-1_DWIL-LTR,Gypsy,LTR,3,1,3,1,8
GYPSY1-I_DM:GYPSY1-LTR_DM,Gypsy,LTR,13368,109,8259,87,21823
GYPSY1-I_DM,Gypsy,LTR,12868,188,8115,139,21310
GYPSY1-I_DMOJ,Gypsy,LTR,73,32,62,23,190
GYPSY1-I_DPSE,Gypsy,LTR,53,1,43,1,98
GYPSY1-I_DV,Gypsy,LTR,33,17,30,11,91
GYPSY1-I_DYA,Gypsy,LTR,202,121,178,110,611
GYPSY1-LTR_DM,Gypsy,LTR,1060,8,716,5,1789
GYPSY1-LTR_DMOJ,Gypsy,LTR,1287,176,970,150,2583
GYPSY1-LTR_DV,Gypsy,LTR,0,0,0,0,0
GYPSY1-LTR_DYA,Gypsy,LTR,297,2,280,1,580
GYPSY-20_DAN-I,Gypsy,LTR,83,46,77,41,247
GYPSY-20_DAN-LTR,Gypsy,LTR,7,5,6,2,20
GYPSY-20_DBP-I:GYPSY-20_DBP-LTR,Gypsy,LTR,0,0,0,0,0
GYPSY-20_DBP-I,Gypsy,LTR,966,121,879,82,2048
GYPSY-20_DBP-LTR,Gypsy,LTR,0,0,0,0,0
GYPSY-20_DEL-I,Gypsy,LTR,140,69,105,48,362
GYPSY-20_DTA-I,Gypsy,LTR,56,34,54,18,162
GYPSY-20_DTA-LTR,Gypsy,LTR,6,6,6,4,22
GYPSY-20_DWIL-I,Gypsy,LTR,1960,48,1383,37,3428
GYPSY-20_DWIL-LTR,Gypsy,LTR,0,0,0,0,0
GYPSY20-I_DPSE,Gypsy,LTR,175,30,115,19,339
GYPSY20-I_DYA:GYPSY20-LTR_DYA,Gypsy,LTR,9,2,9,0,20
GYPSY20-I_DYA,Gypsy,LTR,731,190,536,151,1608
GYPSY20-LTR_DPSE,Gypsy,LTR,0,0,0,0,0
GYPSY20-LTR_DYA:GYPSY20-I_DYA,Gypsy,LTR,8,1,2,0,11
GYPSY20-LTR_DYA,Gypsy,LTR,15,2,10,2,29
GYPSY-21_DAN-I,Gypsy,LTR,22,6,17,6,51
GYPSY-21_DAN-LTR,Gypsy,LTR,53,19,46,17,135
GYPSY-21_DBP-I,LTR,LTR,756,11,563,9,1339
GYPSY-21_DEL-I,Gypsy,LTR,196,14,128,10,348
GYPSY-21_DEL-LTR,Gypsy,LTR,49,16,35,7,107
GYPSY-21_DWIL-I,Gypsy,LTR,121,3,85,2,211
GYPSY-21_DWIL-LTR,Gypsy,LTR,0,0,0,0,0
GYPSY-21_DYA-I:GYPSY-21_DYA-LTR,Gypsy,LTR,9,5,7,2,23
GYPSY-21_DYA-I,Gypsy,LTR,129,52,107,45,333
GYPSY-21_DYA-LTR,Gypsy,LTR,0,0,0,0,0
GYPSY-21_DY-I,Gypsy,LTR,789,34,743,24,1590
GYPSY-21_DY-LTR:GYPSY-21_DY-I,Gypsy,LTR,4,2,3,2,11
GYPSY-21_DY-LTR,Gypsy,LTR,9,3,6,3,21
GYPSY21-I_DPSE,Gypsy,LTR,11,7,10,6,34
GYPSY21-LTR_DPSE,Gypsy,LTR,4,2,4,0,10
GYPSY-22_DAN-I,Gypsy,LTR,850,37,599,27,1513
GYPSY-22_DAN-LTR:GYPSY-22_DAN-I,Gypsy,LTR,0,0,0,0,0
GYPSY-22_DAN-LTR,Gypsy,LTR,0,0,0,0,0
GYPSY-22_DBP-I,Gypsy,LTR,47,1,36,1,85
GYPSY-22_DBP-LTR,Gypsy,LTR,1,1,1,1,4
GYPSY-22_DEL-I,Gypsy,LTR,69,4,60,3,136
GYPSY-22_DEL-LTR,Gypsy,LTR,26,0,15,0,41
GYPSY-22_DWIL-I,Gypsy,LTR,597,250,516,198,1561
GYPSY-22_DWIL-LTR,Gypsy,LTR,231,86,119,80,516
GYPSY-22_DYA-I:GYPSY-22_DYA-LTR,Gypsy,LTR,47,13,43,9,112
GYPSY-22_DYA-I,Gypsy,LTR,334,111,278,86,809
GYPSY-22_DYA-LTR:GYPSY-22_DYA-I,Gypsy,LTR,35,14,27,14,90
GYPSY-22_DYA-LTR,Gypsy,LTR,4,1,2,1,8
GYPSY-22_DY-I,Gypsy,LTR,636,33,427,22,1118
GYPSY-22_DY-LTR,LTR,LTR,111,55,98,46,310
GYPSY22-I_DPSE,Gypsy,LTR,58,28,53,13,152
GYPSY-23_DAN-I,Gypsy,LTR,17,8,15,5,45
GYPSY-23_DAN-LTR,Gypsy,LTR,428,9,308,7,752
GYPSY-23_DBP-I,Gypsy,LTR,61,32,52,26,171
GYPSY-23_DEL-I,Gypsy,LTR,883,499,789,403,2574
GYPSY-23_DWIL-I,Gypsy,LTR,84,5,54,2,145
GYPSY-23_DWIL-LTR,Gypsy,LTR,0,0,0,0,0
GYPSY-23_DYA-I,Gypsy,LTR,914,56,642,39,1651
GYPSY-23_DYA-LTR,Gypsy,LTR,0,0,0,0,0
GYPSY-23_DY-I,Gypsy,LTR,203,19,152,16,390
GYPSY-23_DY-LTR,Gypsy,LTR,33,7,25,7,72
GYPSY23-I_DPSE,Gypsy,LTR,137,39,121,27,324
GYPSY23-LTR_DPSE,Gypsy,LTR,143,60,137,58,398
GYPSY-24_DAN-I,Gypsy,LTR,95,3,58,2,158
GYPSY-24_DAN-LTR,Gypsy,LTR,14,14,14,2,44
GYPSY-24_DBP-I,Gypsy,LTR,173,24,119,19,335
GYPSY-24_DEL-I,Gypsy,LTR,252,41,223,33,549
GYPSY-24_DEL-LTR,Gypsy,LTR,191,1,117,1,310
GYPSY-24_DWIL-I,Gypsy,LTR,4388,41,3407,38,7874
GYPSY-24_DWIL-LTR,Gypsy,LTR,1,0,0,0,1
GYPSY-24_DYA-I:GYPSY-24_DYA-LTR,Gypsy,LTR,383,12,244,9,648
GYPSY-24_DYA-I,Gypsy,LTR,9590,196,6432,147,16365
GYPSY-24_DYA-LTR:GYPSY-24_DYA-I:GYPSY-24_DYA-LTR,Gypsy,LTR,2871,35,1890,23,4819
GYPSY-24_DYA-LTR:GYPSY-24_DYA-I,Gypsy,LTR,5388,148,3573,111,9220
GYPSY-24_DYA-LTR,Gypsy,LTR,134,0,97,0,231
GYPSY-24_DY-I,Gypsy,LTR,1088,77,769,55,1989
GYPSY-24_DY-LTR:GYPSY-24_DY-I,Gypsy,LTR,8,4,7,3,22
GYPSY-24_DY-LTR,Gypsy,LTR,0,0,0,0,0
GYPSY24-I_DPSE,Gypsy,LTR,70,30,56,21,177
GYPSY24-LTR_DPSE,Gypsy,LTR,5,2,5,2,14
GYPSY-25_DAN-I,Gypsy,LTR,68,10,61,8,147
GYPSY-25_DAN-LTR,Gypsy,LTR,14,5,9,5,33
GYPSY-25_DBP-I,Gypsy,LTR,19,4,12,3,38
GYPSY-25_DEL-I,Gypsy,LTR,455,46,353,31,885
GYPSY-25_DP-I,Gypsy,LTR,74,10,56,10,150
GYPSY-25_DP-LTR,Gypsy,LTR,18,6,13,5,42
GYPSY-25_DPSE-I,Gypsy,LTR,27,7,24,6,64
GYPSY-25_DPSE-LTR,Gypsy,LTR,189,11,138,8,346
GYPSY-25_DWIL-I,Gypsy,LTR,15,7,12,5,39
GYPSY-25_DWIL-LTR,Gypsy,LTR,1,1,1,1,4
GYPSY-25_DYA-I,Gypsy,LTR,36,15,36,13,100
GYPSY-25_DYA-LTR,Gypsy,LTR,0,0,0,0,0
GYPSY-26_DAN-I,Gypsy,LTR,25,2,20,1,48
GYPSY-26_DAN-LTR,Gypsy,LTR,0,0,0,0,0
GYPSY-26_DBP-I,Gypsy,LTR,6352,459,3919,423,11153
GYPSY-26_DEL-I,Gypsy,LTR,123,5,90,5,223
GYPSY-26_DP-I,Gypsy,LTR,80,15,63,8,166
GYPSY-26_DP-LTR,Gypsy,LTR,40,4,29,3,76
GYPSY-26_DPSE-I,Gypsy,LTR,1056,105,790,81,2032
GYPSY-26_DPSE-LTR,Gypsy,LTR,0,0,0,0,0
GYPSY-26_DWIL-I,Gypsy,LTR,137,17,114,10,278
GYPSY-26_DWIL-LTR,Gypsy,LTR,0,0,0,0,0
GYPSY-26_DYA-I:GYPSY-26_DYA-LTR,Gypsy,LTR,634,65,416,55,1170
GYPSY-26_DYA-I,Gypsy,LTR,22310,827,15969,633,39739
GYPSY-26_DYA-LTR:GYPSY-26_DYA-I:GYPSY-26_DYA-LTR,Gypsy,LTR,100,11,84,11,206
GYPSY-26_DYA-LTR:GYPSY-26_DYA-I,Gypsy,LTR,1348,118,872,100,2438
GYPSY-26_DYA-LTR,Gypsy,LTR,1214,554,1003,322,3093
GYPSY-27_DAN-I,Gypsy,LTR,19,11,17,3,50
GYPSY-27_DAN-LTR,Gypsy,LTR,25,1,24,1,51
GYPSY-27_DBP-I,Gypsy,LTR,46,29,38,17,130
GYPSY-27_DEL-I,Gypsy,LTR,180,19,113,11,323
GYPSY-27_DEL-LTR,Gypsy,LTR,7,4,5,1,17
GYPSY-27_DP-I,Gypsy,LTR,83,33,59,25,200
GYPSY-27_DP-LTR,Gypsy,LTR,0,0,0,0,0
GYPSY-27_DWIL-I,Gypsy,LTR,25,11,23,11,70
GYPSY-27_DWIL-LTR,Gypsy,LTR,5,0,5,0,10
GYPSY-27_DYA-I:GYPSY-27_DYA-LTR,Gypsy,LTR,856,50,505,31,1442
GYPSY-27_DYA-I,Gypsy,LTR,3179,462,2144,432,6217
GYPSY-27_DYA-LTR:GYPSY-27_DYA-I:GYPSY-27_DYA-LTR,Gypsy,LTR,452,71,286,32,841
GYPSY-27_DYA-LTR:GYPSY-27_DYA-I,Gypsy,LTR,2917,96,1828,59,4900
GYPSY-27_DYA-LTR,Gypsy,LTR,22,4,14,1,41
GYPSY-28_DAN-I,Gypsy,LTR,62,32,57,21,172
GYPSY-28_DAN-LTR:GYPSY-28_DAN-I,Gypsy,LTR,2,1,2,1,6
GYPSY-28_DAN-LTR,Gypsy,LTR,180,43,143,40,406
GYPSY-28_DBP-I,Gypsy,LTR,1074,83,778,70,2005
GYPSY-28_DEL-I,Gypsy,LTR,52,26,49,25,152
GYPSY-28_DEL-LTR,Gypsy,LTR,10,1,4,0,15
GYPSY-28_DWIL-I,Gypsy,LTR,54,2,42,2,100
GYPSY-28_DWIL-LTR,Gypsy,LTR,0,0,0,0,0
GYPSY-28_DYA-I,Gypsy,LTR,177,75,131,54,437
GYPSY-28_DYA-LTR,Gypsy,LTR,76,33,63,13,185
GYPSY-29_DAN-I,Gypsy,LTR,329,50,205,42,626
GYPSY-29_DAN-LTR,Gypsy,LTR,74,5,60,5,144
GYPSY-29_DEL-I,Gypsy,LTR,35,7,31,3,76
GYPSY-29_DWIL-I,Gypsy,LTR,221,149,197,144,711
GYPSY-29_DWIL-LTR,Gypsy,LTR,1,0,0,0,1
GYPSY-29_DYA-I,LTR,LTR,150,42,113,34,339
GYPSY-29_DYA-LTR,Gypsy,LTR,15,7,14,4,40
GYPSY-2_DAN-I,Gypsy,LTR,555,242,416,220,1433
GYPSY-2_DAN-LTR,Gypsy,LTR,6,0,6,0,12
GYPSY-2_DBI-I,Gypsy,LTR,22,10,16,9,57
GYPSY-2_DBI-LTR,Gypsy,LTR,0,0,0,0,0
GYPSY-2_DBP-I,Gypsy,LTR,2008,491,1122,367,3988
GYPSY-2_DBP-LTR,Gypsy,LTR,26,2,24,2,54
GYPSY-2_DEL-I,Gypsy,LTR,123,81,114,68,386
GYPSY-2_DEL-LTR,Gypsy,LTR,3,0,3,0,6
GYPSY-2_DEU-I,Gypsy,LTR,41,8,28,8,85
GYPSY-2_DEU-LTR,Gypsy,LTR,20,0,16,0,36
GYPSY-2_DFI-I,Gypsy,LTR,11,8,11,6,36
GYPSY-2_DFI-LTR,Gypsy,LTR,3,0,2,0,5
GYPSY-2_DGRI-I,Gypsy,LTR,354,103,270,100,827
GYPSY-2_DGRI-LTR,Gypsy,LTR,0,0,0,0,0
GYPSY-2_DKI-I,Gypsy,LTR,13,7,11,3,34
GYPSY-2_DKI-LTR,Gypsy,LTR,0,0,0,0,0
GYPSY-2_DPER-I,Gypsy,LTR,556,118,450,95,1219
GYPSY-2_DRH-I,LTR,LTR,369,77,257,72,775
GYPSY-2_DRH-LTR,LTR,LTR,182,12,117,10,321
GYPSY-2_DSE-I,LTR,LTR,14897,375,10602,274,26148
GYPSY-2_DSE-LTR,Gypsy,LTR,371,6,261,5,643
GYPSY-2_DSIM-I:GYPSY-2_DSIM-LTR,Gypsy,LTR,1769,51,1358,44,3222
GYPSY-2_DSIM-I,Gypsy,LTR,2052,141,1286,121,3600
GYPSY-2_DSIM-LTR:GYPSY-2_DSIM-I:GYPSY-2_DSIM-LTR,Gypsy,LTR,938,17,683,13,1651
GYPSY-2_DSIM-LTR:GYPSY-2_DSIM-I,Gypsy,LTR,2824,83,1892,75,4874
GYPSY-2_DSIM-LTR,Gypsy,LTR,4177,110,3078,92,7457
GYPSY-2_DTA-I,Gypsy,LTR,169,68,134,56,427
GYPSY-2_DTA-LTR,Gypsy,LTR,0,0,0,0,0
GYPSY-2_DVIR-I,Gypsy,LTR,48,13,41,8,110
GYPSY-2_DVIR-LTR,Gypsy,LTR,0,0,0,0,0
GYPSY-2_DWIL-I,Gypsy,LTR,100,50,86,26,262
GYPSY-2_DWIL-LTR,Gypsy,LTR,21,16,21,14,72
GYPSY2,Gypsy,LTR-Retrotransposon,4842,360,3196,289,8687
GYPSY2-I_DM:GYPSY2-LTR_DM,Gypsy,LTR,32,2,24,2,60
GYPSY2-I_DM,Gypsy,LTR,5104,252,3084,213,8653
GYPSY2-I_DMOJ,Gypsy,LTR,169,25,97,24,315
GYPSY2-I_DPSE,Gypsy,LTR,28,21,28,17,94
GYPSY2-I_DV,Gypsy,LTR,200,7,124,5,336
GYPSY2-I_DYA,Gypsy,LTR,16,5,11,4,36
GYPSY2_I-INT:GYPSY2_LTR,Gypsy,LTR,62,16,37,6,121
GYPSY2_I-INT,Gypsy,LTR,590,167,436,72,1265
GYPSY2-LTR_DM:GYPSY2-I_DM,Gypsy,LTR,701,19,448,14,1182
GYPSY2-LTR_DM,Gypsy,LTR,891,57,482,49,1479
GYPSY2-LTR_DMOJ,Gypsy,LTR,0,0,0,0,0
GYPSY2-LTR_DV,Gypsy,LTR,4,4,4,4,16
GYPSY2-LTR_DYA,Gypsy,LTR,1,1,1,0,3
GYPSY2_LTR:GYPSY2_I-INT,Gypsy,LTR,291,99,217,71,678
GYPSY2_LTR,Gypsy,LTR,14,7,13,3,37
GYPSY-30_DAN-I,Gypsy,LTR,124,13,96,11,244
GYPSY-30_DAN-LTR,Gypsy,LTR,7,3,7,3,20
GYPSY-30_DEL-I,Gypsy,LTR,3,1,2,1,7
GYPSY-30_DEL-LTR,Gypsy,LTR,7,1,3,1,12
GYPSY-30_DWIL-I,Gypsy,LTR,1408,122,982,108,2620
GYPSY-30_DWIL-LTR,Gypsy,LTR,0,0,0,0,0
GYPSY-30_DYA-I,Gypsy,LTR,218,94,203,69,584
GYPSY-30_DYA-LTR,Gypsy,LTR,8,5,7,5,25
GYPSY-31_DAN-I,Gypsy,LTR,198,123,158,107,586
GYPSY-31_DAN-LTR,Gypsy,LTR,2,1,2,1,6
GYPSY-31_DEL-I,Gypsy,LTR,10403,153,6802,134,17492
GYPSY-31_DEL-LTR,Gypsy,LTR,14,5,13,3,35
GYPSY-31_DP-I,Gypsy,LTR,19,9,16,7,51
GYPSY-31_DP-LTR,Gypsy,LTR,12,6,12,2,32
GYPSY-31_DWIL-I,Gypsy,LTR,525,43,312,39,919
GYPSY-31_DWIL-LTR,Gypsy,LTR,228,1,148,1,378
GYPSY-31_DYA-I:GYPSY-31_DYA-LTR,Gypsy,LTR,118,15,102,10,245
GYPSY-31_DYA-I,Gypsy,LTR,4527,281,2879,225,7912
GYPSY-31_DYA-LTR:GYPSY-31_DYA-I,Gypsy,LTR,9,5,9,4,27
GYPSY-31_DYA-LTR,Gypsy,LTR,26,1,23,1,51
GYPSY-32_DAN-I,Gypsy,LTR,148,20,117,15,300
GYPSY-32_DAN-LTR,Gypsy,LTR,331,20,236,13,600
GYPSY-32_DEL-I,Gypsy,LTR,213,66,162,43,484
GYPSY-32_DP-I,LTR,LTR,92,31,70,25,218
GYPSY-32_DP-LTR,Gypsy,LTR,1,1,1,0,3
GYPSY-32_DWIL-I,Gypsy,LTR,14,7,14,5,40
GYPSY-32_DWIL-LTR,Gypsy,LTR,4,2,4,1,11
GYPSY-32_DYA-I,Gypsy,LTR,33,12,25,9,79
GYPSY-32_DYA-LTR,Gypsy,LTR,9,6,8,3,26
GYPSY-33_DAN-I,Gypsy,LTR,5720,16,4569,12,10317
GYPSY-33_DAN-LTR,Gypsy,LTR,45,42,45,17,149
GYPSY-33_DEL-I,Gypsy,LTR,345,23,202,13,583
GYPSY-33_DWIL-I,Gypsy,LTR,15,9,15,9,48
GYPSY-33_DWIL-LTR,Gypsy,LTR,0,0,0,0,0
GYPSY-34_DAN-I,Gypsy,LTR,8,6,8,5,27
GYPSY-34_DAN-LTR,LTR,LTR,0,0,0,0,0
GYPSY-34_DEL-I,Gypsy,LTR,3089,113,1927,88,5217
GYPSY-34_DWIL-I,Gypsy,LTR,481,235,406,199,1321
GYPSY-34_DWIL-LTR,Gypsy,LTR,769,0,607,0,1376
GYPSY-35_DAN-I,Gypsy,LTR,98,21,65,19,203
GYPSY-35_DAN-LTR,Gypsy,LTR,6,1,5,1,13
GYPSY-35_DEL-I,Gypsy,LTR,860,25,414,22,1321
GYPSY-35_DWIL-I,Gypsy,LTR,279,8,217,7,511
GYPSY-36_DAN-I,Gypsy,LTR,18,9,17,6,50
GYPSY-36_DAN-LTR,Gypsy,LTR,0,0,0,0,0
GYPSY-36_DEL-I,Gypsy,LTR,392,9,80,8,489
GYPSY-36_DWIL-I,Gypsy,LTR,42,17,39,7,105
GYPSY-36_DWIL-LTR,Gypsy,LTR,0,0,0,0,0
GYPSY-37B_DWIL-LTR,Gypsy,LTR,21,9,18,9,57
GYPSY-37_DAN-I,Gypsy,LTR,374,31,279,22,706
GYPSY-37_DAN-LTR,Gypsy,LTR,20,14,18,11,63
GYPSY-37_DEL-I,Gypsy,LTR,224,90,175,84,573
GYPSY-37_DWIL-I,Gypsy,LTR,3466,31,1048,28,4573
GYPSY-37_DWIL-LTR,Gypsy,LTR,38,14,27,6,85
GYPSY-38_DAN-I,Gypsy,LTR,737,26,346,19,1128
GYPSY-38_DAN-LTR,Gypsy,LTR,40,34,39,31,144
GYPSY-38_DEL-I,Gypsy,LTR,43,16,36,13,108
GYPSY-38_DWIL-I,Gypsy,LTR,56,23,50,18,147
GYPSY-38_DWIL-LTR,Gypsy,LTR,182,0,145,0,327
GYPSY-39_DAN-I,Gypsy,LTR,31,8,22,8,69
GYPSY-39_DAN-LTR,Gypsy,LTR,2,1,2,1,6
GYPSY-39_DWIL-LTR,Gypsy,LTR,304,2,251,0,557
GYPSY-3_DAN-I,Gypsy,LTR,56,22,47,18,143
GYPSY-3_DAN-LTR,Gypsy,LTR,10,4,8,3,25
GYPSY-3_DBI-I,Gypsy,LTR,201,37,152,33,423
GYPSY-3_DBI-LTR,Gypsy,LTR,0,0,0,0,0
GYPSY-3_DBP-I,Gypsy,LTR,28,7,12,5,52
GYPSY-3_DBP-LTR,Gypsy,LTR,0,0,0,0,0
GYPSY-3_DEL-I,LTR,LTR,129,11,90,8,238
GYPSY-3_DEL-LTR,Gypsy,LTR,6,0,5,0,11
GYPSY-3_DEU-I,LTR,LTR,732,15,415,13,1175
GYPSY-3_DEU-LTR,Gypsy,LTR,13,1,12,1,27
GYPSY-3_DFI-I,Gypsy,LTR,25,15,22,8,70
GYPSY-3_DFI-LTR,Gypsy,LTR,0,0,0,0,0
GYPSY-3_DGRI-I,Gypsy,LTR,181,17,107,15,320
GYPSY-3_DGRI-LTR,LTR,LTR,4,0,3,0,7
GYPSY-3_DKI-I,Gypsy,LTR,33444,544,25229,477,59694
GYPSY-3_DKI-LTR,LTR,LTR,65,4,46,4,119
GYPSY-3_DPER-I,Gypsy,LTR,153,106,128,103,490
GYPSY-3_DPER-LTR,Gypsy,LTR,91,13,55,10,169
GYPSY-3_DRH-I,LTR,LTR,563,263,480,218,1524
GYPSY-3_DRH-LTR,LTR,LTR,98,52,87,28,265
GYPSY-3_DSE-I:GYPSY-3_DSE-LTR,Gypsy,LTR,277,9,174,6,466
GYPSY-3_DSE-I,Gypsy,LTR,11181,286,6861,213,18541
GYPSY-3_DSE-LTR:GYPSY-3_DSE-I:GYPSY-3_DSE-LTR,Gypsy,LTR,5853,124,3609,93,9679
GYPSY-3_DSE-LTR:GYPSY-3_DSE-I,Gypsy,LTR,724,37,496,20,1277
GYPSY-3_DSE-LTR,Gypsy,LTR,137,18,93,12,260
GYPSY-3_DSIM-I:GYPSY-3_DSIM-LTR,Gypsy,LTR,17395,12016,15505,11629,56545
GYPSY-3_DSIM-I,Gypsy,LTR,7819,207,4557,159,12742
GYPSY-3_DSIM-LTR:GYPSY-3_DSIM-I:GYPSY-3_DSIM-LTR,Gypsy,LTR,2441,36,1463,29,3969
GYPSY-3_DSIM-LTR:GYPSY-3_DSIM-I,Gypsy,LTR,60,0,14,0,74
GYPSY-3_DSIM-LTR,Gypsy,LTR,2,1,2,1,6
GYPSY-3_DTA-I,Gypsy,LTR,52,9,38,2,101
GYPSY-3_DTA-LTR,Gypsy,LTR,3,1,3,0,7
GYPSY3_DV-I,Gypsy,LTR,12186,43,9209,31,21469
GYPSY-3_DVIR-I,Gypsy,LTR,45,19,38,16,118
GYPSY-3_DVIR-LTR,Gypsy,LTR,0,0,0,0,0
GYPSY3_DV-LTR,Gypsy,LTR,0,0,0,0,0
GYPSY-3_DWIL-I,Gypsy,LTR,44,9,34,3,90
GYPSY3,Gypsy,LTR-Retrotransposon,1882,52,1235,34,3203
GYPSY3-I_DMOJ,Gypsy,LTR,3389,48,2415,38,5890
GYPSY3-I_DPSE,Gypsy,LTR,1088,167,750,126,2131
GYPSY3-I_DYA:GYPSY3-LTR_DYA,Gypsy,LTR,25,14,25,9,73
GYPSY3-I_DYA,Gypsy,LTR,50,16,38,13,117
GYPSY3_I-INT,Gypsy,LTR,3925,71,2346,59,6401
GYPSY3-LTR_DPSE,Gypsy,LTR,1,1,1,1,4
GYPSY3-LTR_DYA,Gypsy,LTR,31,2,26,2,61
GYPSY3_LTR,Gypsy,LTR,568,12,371,9,960
GYPSY-40_DAN-I,Gypsy,LTR,839,148,615,90,1692
GYPSY-40_DAN-LTR:GYPSY-40_DAN-I,Gypsy,LTR,7,0,7,0,14
GYPSY-40_DAN-LTR,Gypsy,LTR,73,2,53,2,130
GYPSY-40_DEL-I,Gypsy,LTR,32,1,26,1,60
GYPSY-40_DWIL-LTR,Gypsy,LTR,3,0,3,0,6
GYPSY-41_DAN-I,Gypsy,LTR,551,18,416,16,1001
GYPSY-41_DAN-LTR,Gypsy,LTR,427,17,340,16,800
GYPSY-41_DEL-I,Gypsy,LTR,595,182,448,151,1376
GYPSY-41_DWIL-LTR,Gypsy,LTR,0,0,0,0,0
GYPSY-42_DAN-I,Gypsy,LTR,129,16,77,14,236
GYPSY-42_DAN-LTR,Gypsy,LTR,8,4,8,4,24
GYPSY-42_DEL-I,Gypsy,LTR,91,36,69,23,219
GYPSY-42_DWIL-I,Gypsy,LTR,150,13,94,13,270
GYPSY-42_DWIL-LTR,Gypsy,LTR,0,0,0,0,0
GYPSY-43_DEL-I,Gypsy,LTR,45,14,36,11,106
GYPSY-43_DWIL-I,Gypsy,LTR,79,59,76,40,254
GYPSY-43_DWIL-LTR,Gypsy,LTR,0,0,0,0,0
GYPSY-44_DEL-I,LTR,LTR,209,8,138,6,361
GYPSY-44_DEL-LTR,Gypsy,LTR,5,2,4,2,13
GYPSY-44_DWIL-I,Gypsy,LTR,72,59,69,41,241
GYPSY-44_DWIL-LTR,Gypsy,LTR,0,0,0,0,0
GYPSY-45_DEL-I,Gypsy,LTR,49,0,36,0,85
GYPSY-45_DEL-LTR,Gypsy,LTR,0,0,0,0,0
GYPSY-45_DWIL-I,Gypsy,LTR,5259,85,4052,63,9459
GYPSY-45_DWIL-LTR,Gypsy,LTR,1,1,1,1,4
GYPSY-46_DEL-I,Gypsy,LTR,11,7,10,5,33
GYPSY-46_DEL-LTR,Gypsy,LTR,57,5,40,3,105
GYPSY-46_DWIL-I,Gypsy,LTR,80,14,51,5,150
GYPSY-46_DWIL-LTR,Gypsy,LTR,0,0,0,0,0
GYPSY-47_DEL-I,Gypsy,LTR,1209,59,695,37,2000
GYPSY-47_DWIL-I,Gypsy,LTR,45,15,35,6,101
GYPSY-47_DWIL-LTR,Gypsy,LTR,0,0,0,0,0
GYPSY-48_DEL-I,Gypsy,LTR,980,187,729,169,2065
GYPSY-48_DEL-LTR,Gypsy,LTR,1,1,1,0,3
GYPSY-48_DWIL-I,Gypsy,LTR,1195,1155,1190,821,4361
GYPSY-48_DWIL-LTR,Gypsy,LTR,1,1,1,1,4
GYPSY-49_DEL-I,Gypsy,LTR,13,2,8,2,25
GYPSY-49_DWIL-I,Gypsy,LTR,75,12,53,9,149
GYPSY-49_DWIL-LTR,Gypsy,LTR,0,0,0,0,0
GYPSY-4_DAN-I:GYPSY-4_DAN-LTR,Gypsy,LTR,1,0,1,0,2
GYPSY-4_DAN-I,Gypsy,LTR,242,24,230,14,510
GYPSY-4_DAN-LTR:GYPSY-4_DAN-I,Gypsy,LTR,63,43,57,33,196
GYPSY-4_DAN-LTR,Gypsy,LTR,10,5,9,4,28
GYPSY-4_DBI-I:GYPSY-4_DBI-LTR,Gypsy,LTR,170,27,91,23,311
GYPSY-4_DBI-I,Gypsy,LTR,4413,2688,3739,2556,13396
GYPSY-4_DBI-LTR:GYPSY-4_DBI-I,Gypsy,LTR,138,18,93,9,258
GYPSY-4_DBI-LTR,Gypsy,LTR,440,23,217,16,696
GYPSY-4_DBP-I,Gypsy,LTR,62,13,48,9,132
GYPSY-4_DBP-LTR,Gypsy,LTR,0,0,0,0,0
GYPSY-4_DEL-I,Gypsy,LTR,36,14,31,12,93
GYPSY-4_DEL-LTR,Gypsy,LTR,0,0,0,0,0
GYPSY-4_DEU-I,Gypsy,LTR,46,5,44,3,98
GYPSY-4_DEU-LTR,Gypsy,LTR,1,1,1,1,4
GYPSY-4_DFI-I,Gypsy,LTR,22,11,20,9,62
GYPSY-4_DFI-LTR,Gypsy,LTR,0,0,0,0,0
GYPSY-4_DGRI-I,Gypsy,LTR,25,20,24,15,84
GYPSY-4_DGRI-LTR,Gypsy,LTR,8,5,5,5,23
GYPSY-4_DKI-I,Gypsy,LTR,56,43,50,38,187
GYPSY-4_DKI-LTR,Gypsy,LTR,0,0,0,0,0
GYPSY-4_DPER-I,Gypsy,LTR,5,2,4,2,13
GYPSY-4_DPER-LTR,Gypsy,LTR,1,0,1,0,2
GYPSY-4_DRH-I,LTR,LTR,305,12,200,7,524
GYPSY-4_DRH-LTR,LTR,LTR,2,1,1,1,5
GYPSY-4_DSE-I,Gypsy,LTR,726,157,570,146,1599
GYPSY-4_DSE-LTR,Gypsy,LTR,16,2,9,1,28
GYPSY-4_DSIM-I:GYPSY-4_DSIM-LTR,Gypsy,LTR,25453,22812,24281,22151,94697
GYPSY-4_DSIM-I,Gypsy,LTR,6447,554,3184,484,10669
GYPSY-4_DSIM-LTR:GYPSY-4_DSIM-I:GYPSY-4_DSIM-LTR,Gypsy,LTR,970,75,363,63,1471
GYPSY-4_DSIM-LTR:GYPSY-4_DSIM-I,Gypsy,LTR,721,93,295,67,1176
GYPSY-4_DSIM-LTR,Gypsy,LTR,160,6,57,3,226
GYPSY-4_DTA-I,Gypsy,LTR,125,31,104,24,284
GYPSY-4_DTA-LTR,Gypsy,LTR,2,1,2,0,5
GYPSY-4_DVIR-I,Gypsy,LTR,1915,45,1248,34,3242
GYPSY-4_DVIR-LTR,Gypsy,LTR,1,1,1,1,4
GYPSY-4_DWIL-I,Gypsy,LTR,24,7,17,6,54
GYPSY-4_DWIL-LTR,Gypsy,LTR,3,3,3,1,10
GYPSY4,Gypsy,LTR-Retrotransposon,1864,62,1368,46,3340
GYPSY4-I_DMOJ,Gypsy,LTR,58,16,42,12,128
GYPSY4-I_DPSE,Gypsy,LTR,29,22,27,20,98
GYPSY4-I_DYA,Gypsy,LTR,774,290,667,236,1967
GYPSY4_I-INT:GYPSY4_LTR,Gypsy,LTR,970,21,643,14,1648
GYPSY4_I-INT,Gypsy,LTR,12374,190,8701,163,21428
GYPSY4-LTR_DMOJ,Gypsy,LTR,3,0,3,0,6
GYPSY4-LTR_DPSE,Gypsy,LTR,6,5,6,2,19
GYPSY4-LTR_DYA,Gypsy,LTR,46,22,37,17,122
GYPSY4_LTR:GYPSY4_I-INT,Gypsy,LTR,663,12,447,6,1128
GYPSY4_LTR,Gypsy,LTR,35,0,31,0,66
GYPSY-50_DWIL-I,Gypsy,LTR,51,15,42,11,119
GYPSY-50_DWIL-LTR,Gypsy,LTR,27,7,23,5,62
GYPSY-51_DEL-I,Gypsy,LTR,38,14,29,8,89
GYPSY-51_DWIL-I,Gypsy,LTR,72,32,57,23,184
GYPSY-51_DWIL-LTR,Gypsy,LTR,1,0,1,0,2
GYPSY-52_DEL-I,Gypsy,LTR,401,34,287,25,747
GYPSY-52_DWIL-I,Gypsy,LTR,249,36,176,28,489
GYPSY-52_DWIL-LTR,Gypsy,LTR,1,0,1,0,2
GYPSY-53_DEL-I,Gypsy,LTR,17820,168,10302,126,28416
GYPSY-53_DWIL-I,Gypsy,LTR,1004,29,928,25,1986
GYPSY-53_DWIL-LTR,Gypsy,LTR,1,0,1,0,2
GYPSY-54_DEL-I,Gypsy,LTR,113,21,84,13,231
GYPSY-54_DEL-LTR:GYPSY-54_DEL-I,Gypsy,LTR,0,0,0,0,0
GYPSY-54_DEL-LTR,Gypsy,LTR,1,0,1,0,2
GYPSY-54_DWIL-I,Gypsy,LTR,117,36,91,29,273
GYPSY-54_DWIL-LTR,Gypsy,LTR,5,5,5,2,17
GYPSY-55_DEL-I,Gypsy,LTR,284,32,204,22,542
GYPSY-55_DWIL-I,Gypsy,LTR,338,9,234,9,590
GYPSY-55_DWIL-LTR,Gypsy,LTR,0,0,0,0,0
GYPSY-56_DEL-LTR,Gypsy,LTR,1,0,1,0,2
GYPSY-56_DWIL-I,Gypsy,LTR,83,40,73,26,222
GYPSY-56_DWIL-LTR,Gypsy,LTR,1,0,1,0,2
GYPSY-57_DEL-I,Gypsy,LTR,1081,1019,1068,976,4144
GYPSY-57_DWIL-I,Gypsy,LTR,2289,16,1676,14,3995
GYPSY-57_DWIL-LTR,Gypsy,LTR,2,1,2,1,6
GYPSY-58_DWIL-I,Gypsy,LTR,41,6,23,3,73
GYPSY-58_DWIL-LTR,Gypsy,LTR,1,0,1,0,2
GYPSY-59_DWIL-I,Gypsy,LTR,15,1,9,0,25
GYPSY-59_DWIL-LTR,Gypsy,LTR,0,0,0,0,0
GYPSY-5_DAN-I,Gypsy,LTR,72,17,55,14,158
GYPSY-5_DAN-LTR,Gypsy,LTR,41,3,29,2,75
GYPSY-5_DBI-I,Gypsy,LTR,63,25,52,10,150
GYPSY-5_DBI-LTR,Gypsy,LTR,6,5,6,3,20
GYPSY-5_DBP-I,Gypsy,LTR,725,72,581,63,1441
GYPSY-5_DBP-LTR,Gypsy,LTR,0,0,0,0,0
GYPSY-5_DEL-I:GYPSY-5_DEL-LTR,Gypsy,LTR,10,3,10,2,25
GYPSY-5_DEL-I,Gypsy,LTR,71,41,62,29,203
GYPSY-5_DEL-LTR:GYPSY-5_DEL-I,Gypsy,LTR,0,0,0,0,0
GYPSY-5_DEL-LTR,Gypsy,LTR,42,13,35,10,100
GYPSY-5_DER-LTR,Gypsy,LTR,4,1,4,0,9
GYPSY-5_DEU-I,Gypsy,LTR,84,73,82,72,311
GYPSY-5_DEU-LTR,Gypsy,LTR,3,1,3,1,8
GYPSY-5_DFI-I,Gypsy,LTR,16,7,16,2,41
GYPSY-5_DGRI-I,Gypsy,LTR,372,40,241,31,684
GYPSY-5_DGRI-LTR,Gypsy,LTR,1,1,1,1,4
GYPSY-5_DKI-I,Gypsy,LTR,212,24,157,18,411
GYPSY-5_DKI-LTR,Gypsy,LTR,54,8,34,7,103
GYPSY-5_DPER-I,Gypsy,LTR,29,5,24,3,61
GYPSY-5_DRH-I,LTR,LTR,88,14,63,10,175
GYPSY-5_DRH-LTR,LTR,LTR,0,0,0,0,0
GYPSY-5_DSE-I,Gypsy,LTR,13986,593,8457,535,23571
GYPSY-5_DSE-LTR,Gypsy,LTR,94,0,60,0,154
GYPSY-5_DSIM-I:GYPSY-5_DSIM-LTR,Gypsy,LTR,2352,26,1369,21,3768
GYPSY-5_DSIM-I,Gypsy,LTR,17902,366,10765,269,29302
GYPSY-5_DSIM-LTR:GYPSY-5_DSIM-I:GYPSY-5_DSIM-LTR,Gypsy,LTR,4294,33,2551,20,6898
GYPSY-5_DSIM-LTR:GYPSY-5_DSIM-I,Gypsy,LTR,630,9,349,6,994
GYPSY-5_DSIM-LTR,Gypsy,LTR,691,8,394,4,1097
GYPSY-5_DTA-I,Gypsy,LTR,177,26,147,21,371
GYPSY-5_DTA-LTR,Gypsy,LTR,1,0,1,0,2
GYPSY-5_DVIR-I,Gypsy,LTR,74,37,50,36,197
GYPSY-5_DVIR-LTR,Gypsy,LTR,1,0,0,0,1
GYPSY-5_DWIL-I,Gypsy,LTR,296,39,260,28,623
GYPSY-5_DWIL-LTR,Gypsy,LTR,17,3,12,2,34
GYPSY5,Gypsy,LTR-Retrotransposon,4243,270,3039,243,7795
GYPSY5-I_DMOJ,Gypsy,LTR,75,55,70,49,249
GYPSY5-I_DPSE,Gypsy,LTR,209,48,153,33,443
GYPSY5-I_DYA:GYPSY5-LTR_DYA,Gypsy,LTR,36,13,32,10,91
GYPSY5-I_DYA,Gypsy,LTR,15,8,15,7,45
GYPSY5_I-INT:GYPSY5_LTR,Gypsy,LTR,18,1,10,1,30
GYPSY5_I-INT,Gypsy,LTR,14380,779,8806,690,24655
GYPSY5-LTR_DMOJ,Gypsy,LTR,73,0,69,0,142
GYPSY5-LTR_DPSE,Gypsy,LTR,11,9,9,9,38
GYPSY5-LTR_DYA,Gypsy,LTR,6,3,6,3,18
GYPSY5_LTR:GYPSY5_I-INT,Gypsy,LTR,3272,152,2319,141,5884
GYPSY5_LTR,Gypsy,LTR,381,22,317,19,739
GYPSY-60_DWIL-I,Gypsy,LTR,48,20,43,17,128
GYPSY-60_DWIL-LTR,Gypsy,LTR,0,0,0,0,0
GYPSY-61_DWIL-I,LTR,LTR,55,9,42,9,115
GYPSY-61_DWIL-LTR,Gypsy,LTR,13,11,13,11,48
GYPSY-62_DWIL-I,Gypsy,LTR,170,20,134,16,340
GYPSY-62_DWIL-LTR,Gypsy,LTR,3,1,2,1,7
GYPSY-63_DWIL-I,Gypsy,LTR,296,233,268,223,1020
GYPSY-63_DWIL-LTR,Gypsy,LTR,0,0,0,0,0
GYPSY-64_DWIL-I,Gypsy,LTR,31,28,29,26,114
GYPSY-64_DWIL-LTR,Gypsy,LTR,1,1,1,1,4
GYPSY6A_LTR:GYPSY_6B,Gypsy,LTR,278,4,186,2,470
GYPSY6A_LTR,Gypsy,LTR,3785,80,2810,51,6726
GYPSY_6B,Gypsy,LTR,20675,519,14470,385,36049
GYPSY-6_DAN-I,LTR,LTR,39,13,29,12,93
GYPSY-6_DAN-LTR,Gypsy,LTR,2,1,1,1,5
GYPSY-6_DBI-I,Gypsy,LTR,70,28,54,18,170
GYPSY-6_DBP-I,Gypsy,LTR,29,13,26,10,78
GYPSY-6_DEL-I,Gypsy,LTR,86,57,81,50,274
GYPSY-6_DEL-LTR,Gypsy,LTR,434,3,313,2,752
GYPSY-6_DEU-I,LTR,LTR,4094,172,2677,133,7076
GYPSY-6_DEU-LTR,Gypsy,LTR,0,0,0,0,0
GYPSY-6_DFI-I,Gypsy,LTR,218,75,180,58,531
GYPSY-6_DFI-LTR,Gypsy,LTR,0,0,0,0,0
GYPSY-6_DGRI-I,Gypsy,LTR,475,362,440,333,1610
GYPSY-6_DPER-I,Gypsy,LTR,530,87,394,66,1077
GYPSY-6_DPER-LTR,Gypsy,LTR,6,3,6,2,17
GYPSY-6_DRH-I,LTR,LTR,552,66,445,53,1116
GYPSY-6_DRH-LTR:GYPSY-6_DRH-I,LTR,LTR,5,3,4,3,15
GYPSY-6_DRH-LTR,LTR,LTR,3,0,2,0,5
GYPSY-6_DSE-I:GYPSY-6_DSE-LTR,Gypsy,LTR,398,143,272,97,910
GYPSY-6_DSE-I,Gypsy,LTR,17416,12784,15543,12365,58108
GYPSY-6_DSE-LTR:GYPSY-6_DSE-I,Gypsy,LTR,2362,191,1423,148,4124
GYPSY-6_DSE-LTR,Gypsy,LTR,338,10,260,9,617
GYPSY-6_DSIM-I:GYPSY-6_DSIM-LTR,Gypsy,LTR,2664,40,1908,29,4641
GYPSY-6_DSIM-I,Gypsy,LTR,8181,249,5606,218,14254
GYPSY-6_DSIM-LTR:GYPSY-6_DSIM-I,Gypsy,LTR,1129,29,789,27,1974
GYPSY-6_DSIM-LTR,Gypsy,LTR,461,2,303,2,768
GYPSY-6_DTA-I,Gypsy,LTR,109,9,69,8,195
GYPSY-6_DTA-LTR,Gypsy,LTR,22,1,7,0,30
GYPSY-6_DVIR-I,Gypsy,LTR,10,3,7,2,22
GYPSY-6_DVIR-LTR,Gypsy,LTR,0,0,0,0,0
GYPSY-6_DWIL-I,Gypsy,LTR,54,7,41,5,107
GYPSY-6_DWIL-LTR,Gypsy,LTR,2,0,2,0,4
GYPSY6,Gypsy,LTR-Retrotransposon,4484,668,3120,602,8874
GYPSY6-I_DMOJ,Gypsy,LTR,117,45,98,32,292
GYPSY6-I_DPSE,Gypsy,LTR,69,28,55,22,174
GYPSY6-I_DYA,Gypsy,LTR,158,135,153,116,562
GYPSY6_I-INT,Gypsy,LTR,124,40,91,31,286
GYPSY6-LTR_DMOJ,Gypsy,LTR,5,0,5,0,10
GYPSY6-LTR_DPSE,Gypsy,LTR,4,1,3,1,9
GYPSY6-LTR_DYA,Gypsy,LTR,19,11,15,9,54
GYPSY6_LTR,Gypsy,LTR,1,0,1,0,2
GYPSY-7_DAN-I,Gypsy,LTR,50,42,50,36,178
GYPSY-7_DAN-LTR,Gypsy,LTR,0,0,0,0,0
GYPSY-7_DBI-I,Gypsy,LTR,2441,51,1645,43,4180
GYPSY-7_DBI-LTR,Gypsy,LTR,0,0,0,0,0
GYPSY-7_DBP-I,Gypsy,LTR,407,15,275,11,708
GYPSY-7_DBP-LTR,Gypsy,LTR,0,0,0,0,0
GYPSY-7_DEL-I,Gypsy,LTR,374,13,211,10,608
GYPSY-7_DEL-LTR,Gypsy,LTR,182,5,145,4,336
GYPSY-7_DEU-I,Gypsy,LTR,2629,101,1142,82,3954
GYPSY-7_DEU-LTR,Gypsy,LTR,1,0,0,0,1
GYPSY-7_DFI-I,Gypsy,LTR,192,29,132,27,380
GYPSY-7_DFI-LTR,Gypsy,LTR,0,0,0,0,0
GYPSY-7_DPER-I,Gypsy,LTR,142,51,108,40,341
GYPSY-7_DPER-LTR,Gypsy,LTR,1,0,0,0,1
GYPSY-7_DRH-I,LTR,LTR,63,9,57,9,138
GYPSY-7_DSE-I,LTR,LTR,2468,151,1674,132,4425
GYPSY-7_DSE-LTR,Gypsy,LTR,399,3,243,2,647
GYPSY-7_DSIM-I,Gypsy,LTR,39043,532,25405,433,65413
GYPSY-7_DSIM-LTR,LTR,LTR,3187,54,1895,45,5181
GYPSY-7_DTA-I,Gypsy,LTR,34,18,31,9,92
GYPSY-7_DTA-LTR,Gypsy,LTR,69,7,57,6,139
GYPSY-7_DVIR-I,Gypsy,LTR,382,32,264,28,706
GYPSY-7_DVIR-LTR,Gypsy,LTR,5,4,5,4,18
GYPSY-7_DWIL-I,Gypsy,LTR,33,8,27,8,76
GYPSY-7_DWIL-LTR,Gypsy,LTR,0,0,0,0,0
GYPSY7,Gypsy,LTR-Retrotransposon,193,31,142,27,393
GYPSY7-I_DMOJ,Gypsy,LTR,49,3,31,2,85
GYPSY7-I_DPSE,Gypsy,LTR,218,81,176,76,551
GYPSY7-I_DYA:GYPSY7-LTR_DYA,Gypsy,LTR,24,5,21,3,53
GYPSY7-I_DYA,Gypsy,LTR,571,99,484,77,1231
GYPSY7_I-INT:GYPSY7_LTR,Gypsy,LTR,46,8,33,6,93
GYPSY7_I-INT,Gypsy,LTR,674,69,384,49,1176
GYPSY7-LTR_DMOJ,Gypsy,LTR,0,0,0,0,0
GYPSY7-LTR_DPSE,Gypsy,LTR,0,0,0,0,0
GYPSY7-LTR_DYA,Gypsy,LTR,5,2,4,2,13
GYPSY7_LTR:GYPSY7_I-INT,Gypsy,LTR,7,1,6,0,14
GYPSY7_LTR,Gypsy,LTR,157,3,111,2,273
GYPSY-8_DAN-I,Gypsy,LTR,51,3,21,2,77
GYPSY-8_DAN-LTR,Gypsy,LTR,38,20,33,14,105
GYPSY-8_DBI-I,Gypsy,LTR,314,21,211,17,563
GYPSY-8_DBI-LTR,Gypsy,LTR,2,0,2,0,4
GYPSY-8_DBP-I,Gypsy,LTR,173,13,132,11,329
GYPSY-8_DEL-I,Gypsy,LTR,325,146,271,122,864
GYPSY-8_DEL-LTR,Gypsy,LTR,8,1,3,1,13
GYPSY-8_DEU-I,Gypsy,LTR,85,59,81,54,279
GYPSY-8_DEU-LTR,Gypsy,LTR,1,1,1,1,4
GYPSY-8_DFI-I,LTR,LTR,233,25,134,21,413
GYPSY-8_DFI-LTR,Gypsy,LTR,0,0,0,0,0
GYPSY-8_DMOJ-I,Gypsy,LTR,200,8,115,4,327
GYPSY-8_DMOJ-LTR,Gypsy,LTR,3,2,2,2,9
GYPSY-8_DPER-I,Gypsy,LTR,212,17,155,5,389
GYPSY-8_DPER-LTR,Gypsy,LTR,17,7,14,4,42
GYPSY-8_DRH-I,LTR,LTR,19,6,16,4,45
GYPSY-8_DRH-LTR,LTR,LTR,0,0,0,0,0
GYPSY-8_DSE-I:GYPSY-8_DSE-LTR,Gypsy,LTR,4091,55,3107,43,7296
GYPSY-8_DSE-I,Gypsy,LTR,10493,176,7910,117,18696
GYPSY-8_DSE-LTR:GYPSY-8_DSE-I:GYPSY-8_DSE-LTR,Gypsy,LTR,423,5,328,4,760
GYPSY-8_DSE-LTR:GYPSY-8_DSE-I,Gypsy,LTR,4804,63,3606,44,8517
GYPSY-8_DSE-LTR,Gypsy,LTR,1095,7,870,6,1978
GYPSY-8_DSIM-I,Gypsy,LTR,146395,1380,111544,1202,260521
GYPSY-8_DTA-I,Gypsy,LTR,18,8,13,7,46
GYPSY-8_DTA-LTR,Gypsy,LTR,0,0,0,0,0
GYPSY-8_DVIR-I,Gypsy,LTR,107,24,70,18,219
GYPSY-8_DVIR-LTR,Gypsy,LTR,21,0,12,0,33
GYPSY-8_DWIL-I,Gypsy,LTR,23,4,16,3,46
GYPSY-8_DWIL-LTR,Gypsy,LTR,0,0,0,0,0
GYPSY8,Gypsy,LTR-Retrotransposon,18198,1159,13482,780,33619
GYPSY8-I_DPSE,Gypsy,LTR,2392,1240,2134,1042,6808
GYPSY8-I_DYA:GYPSY8-LTR_DYA,Gypsy,LTR,3,1,3,1,8
GYPSY8-I_DYA,Gypsy,LTR,754,145,583,106,1588
GYPSY8_I-INT:GYPSY8_LTR,Gypsy,LTR,5636,124,3848,92,9700
GYPSY8_I-INT,Gypsy,LTR,48478,1069,36763,867,87177
GYPSY8-LTR_DPSE,Gypsy,LTR,4,3,4,3,14
GYPSY8-LTR_DYA:GYPSY8-I_DYA,Gypsy,LTR,2,2,2,2,8
GYPSY8-LTR_DYA,Gypsy,LTR,82,6,57,4,149
GYPSY8_LTR:GYPSY8_I-INT,Gypsy,LTR,18,1,17,1,37
GYPSY8_LTR,Gypsy,LTR,852,34,589,19,1494
GYPSY-9_DAN-I,Gypsy,LTR,55,9,42,9,115
GYPSY-9_DAN-LTR,Gypsy,LTR,5,3,5,2,15
GYPSY-9_DBI-I,Gypsy,LTR,30,13,25,5,73
GYPSY-9_DBI-LTR,Gypsy,LTR,59,16,44,11,130
GYPSY-9_DBP-I,LTR,LTR,891,318,692,262,2163
GYPSY-9_DBP-LTR,Gypsy,LTR,1,0,1,0,2
GYPSY-9_DEL-I,LTR,LTR,355,16,262,11,644
GYPSY-9_DEL-LTR,Gypsy,LTR,0,0,0,0,0
GYPSY-9_DEU-I,Gypsy,LTR,49,11,35,8,103
GYPSY-9_DFI-I,Gypsy,LTR,1043,50,693,29,1815
GYPSY-9_DFI-LTR,Gypsy,LTR,0,0,0,0,0
GYPSY-9_DMOJ-I,Gypsy,LTR,114,65,100,46,325
GYPSY-9_DMOJ-LTR,Gypsy,LTR,89,6,68,4,167
GYPSY-9_DPER-I,Gypsy,LTR,15,9,11,6,41
GYPSY-9_DPER-LTR,Gypsy,LTR,2,2,2,1,7
GYPSY-9_DRH-I:GYPSY-9_DRH-LTR,LTR,LTR,23,17,21,17,78
GYPSY-9_DRH-I,LTR,LTR,51,16,42,12,121
GYPSY-9_DRH-LTR:GYPSY-9_DRH-I,LTR,LTR,3,1,2,0,6
GYPSY-9_DRH-LTR,LTR,LTR,139,16,103,10,268
GYPSY-9_DSIM-I:GYPSY-9_DSIM-LTR,Gypsy,LTR,283,9,207,8,507
GYPSY-9_DSIM-I,Gypsy,LTR,899,82,647,69,1697
GYPSY-9_DSIM-LTR:GYPSY-9_DSIM-I:GYPSY-9_DSIM-LTR,Gypsy,LTR,780,29,582,27,1418
GYPSY-9_DSIM-LTR:GYPSY-9_DSIM-I,Gypsy,LTR,1155,49,868,36,2108
GYPSY-9_DSIM-LTR,Gypsy,LTR,1520,143,1060,125,2848
GYPSY-9_DTA-I,Gypsy,LTR,104,54,86,29,273
GYPSY-9_DTA-LTR,Gypsy,LTR,6,2,5,1,14
GYPSY-9_DVIR-I,Gypsy,LTR,37,3,21,3,64
GYPSY-9_DVIR-LTR,Gypsy,LTR,2,0,2,0,4
GYPSY-9_DWIL-I,Gypsy,LTR,30,12,27,8,77
GYPSY9,Gypsy,LTR-Retrotransposon,3475,73,2478,60,6086
GYPSY9-I_DPSE,Gypsy,LTR,301,17,162,17,497
GYPSY9-I_DYA:GYPSY9-LTR_DYA,Gypsy,LTR,40,15,37,12,104
GYPSY9-I_DYA,Gypsy,LTR,421,47,288,37,793
GYPSY9_I-INT:GYPSY9_LTR,Gypsy,LTR,3254,54,2170,46,5524
GYPSY9_I-INT,Gypsy,LTR,21399,163,14929,130,36621
GYPSY9-LTR_DPSE,Gypsy,LTR,0,0,0,0,0
GYPSY9-LTR_DYA:GYPSY9-I_DYA,Gypsy,LTR,167,5,101,3,276
GYPSY9-LTR_DYA,Gypsy,LTR,406,18,340,11,775
GYPSY9_LTR:GYPSY9_I-INT:GYPSY9_LTR,Gypsy,LTR,2396,18,1674,15,4103
GYPSY9_LTR:GYPSY9_I-INT,Gypsy,LTR,6175,94,4071,76,10416
GYPSY9_LTR,Gypsy,LTR,1229,20,786,16,2051
GYPSY_DG_I-INT,Gypsy,LTR,44,9,27,6,86
GYPSY_DG_LTR,Gypsy,LTR,11,3,9,2,25
GYPSY_DS,Gypsy,LTR,1487,18,1033,15,2553
GYPSY,Gypsy,LTR-Retrotransposon,3331,179,2068,142,5720
GYPSY_I-INT:GYPSY_DS,Gypsy,LTR,250,14,214,12,490
GYPSY_I-INT,Gypsy,LTR,17750,1081,10842,902,30575
GYPSY_I-INT:GYPSY_LTR,Gypsy,LTR,8761,315,5309,256,14641
GYPSY_LTR:GYPSY_DS,Gypsy,LTR,1,1,1,0,3
GYPSY_LTR:GYPSY_I-INT,Gypsy,LTR,5375,231,3207,195,9008
GYPSY_LTR,Gypsy,LTR,1513,28,958,20,2519
HARBINGER-1_DF,PIF-Harbinger,DNA,14,5,6,3,28
HARBINGER-1_DK,PIF-Harbinger,DNA,29,9,29,8,75
HARBINGER-1_DRH,PIF-Harbinger,DNA,46,3,38,2,89
HARBINGER-1_DW,PIF-Harbinger,DNA,1032,20,758,13,1823
HARBINGER1_DYA,PIF-Harbinger,DNA,314,83,271,57,725
HARBINGER-1N1_DF,PIF-Harbinger,DNA,6,6,6,5,23
HARBINGER-1N1_DK,PIF-Harbinger,DNA,31,4,26,2,63
HARBINGER-1N1_DRH,PIF-Harbinger,DNA,22,2,15,2,41
HARBINGER-2B_DRH,PIF-Harbinger,DNA,209,3,125,1,338
HARBINGER-2_DRH,PIF-Harbinger,DNA,3,2,3,1,9
HARBINGER-N1_DPE,PIF-Harbinger,DNA,24,21,24,21,90
HAT-10_DBP,hAT-hobo,DNA,36,12,34,8,90
HAT-1_DAN,hAT-Charlie,DNA,27,1,19,0,47
HAT-1_DBP,hAT-Blackjack,DNA,27,1,21,1,50
HAT-1_DEL,hAT-Ac,DNA,17,9,16,7,49
HAT-1_DF,hAT-hobo,DNA,10,2,8,2,22
HAT-1_DK,hAT-Ac,DNA,21,8,19,6,54
HAT-1_DP,hAT-Ac,DNA,141,6,106,4,257
HAT-1_DRH,hAT-Ac,DNA,26,3,24,3,56
HAT-1_DSI,hAT-Ac,DNA,8339,41,5402,23,13805
HAT-1_DT,hAT-Pegasus,DNA,69,22,57,12,160
HAT-1N_DP,hAT,DNA,34,3,24,2,63
HAT-1N_DW,hAT-hobo,DNA,3,1,3,1,8
HAT-2_DBP,hAT-Ac,DNA,14,7,10,4,35
HAT-2_DF,hAT-hobo,DNA,13,4,10,3,30
HAT-2_DK,hAT-Ac,DNA,79,43,66,33,221
HAT-2_DRH,hAT-hobo,DNA,62,8,43,5,118
HAT-2_DSE,hAT-Ac,DNA,11403,110,3253,90,14856
HAT-2_DT,hAT-hobo,DNA,72,57,67,53,249
HAT-2_DY,hAT-hobo,DNA,264,167,227,152,810
HAT-2N1_DF,hAT-hobo,DNA,0,0,0,0,0
HAT-3_DBP,hAT-Ac,DNA,3392,3258,3388,3164,13202
HAT-3_DF,hAT-Ac,DNA,0,0,0,0,0
HAT-3_DK,hAT-Ac,DNA,26,1,15,1,43
HAT-3_DRH,hAT-hobo,DNA,9,5,7,2,23
HAT-3_DT,hAT-hobo,DNA,86,5,46,4,141
HAT-4_DBP,hAT-Ac,DNA,8,4,7,2,21
HAT-4_DK,hAT-hobo,DNA,35,32,34,27,128
HAT-4_DRH,hAT-hobo,DNA,238,65,220,60,583
HAT-5_DBP,hAT-Ac,DNA,2,1,1,1,5
HAT-5_DK,hAT-hobo,DNA,8,2,5,2,17
HAT-5_DRH,hAT-Ac,DNA,8,3,8,2,21
HAT-5N1_DK,hAT-hobo,DNA,39,9,31,8,87
HAT-5N1_DRH,hAT-Ac,DNA,3,2,2,1,8
HAT-6_DBP,hAT-hobo,DNA,104,9,85,8,206
HAT-6_DK,hAT-hobo,DNA,11,5,11,4,31
HAT-6_DRH,hAT-Ac,DNA,9,5,7,3,24
HAT-7_DBP,hAT-hobo,DNA,125,17,99,16,257
HAT-8_DBP,hAT-hobo,DNA,9,4,8,4,25
HAT-9_DBP,hAT-Pegasus,DNA,34,8,27,6,75
HAT-N1B_DBP,hAT-Ac,DNA,461,17,302,10,790
HAT-N1_DBP,hAT-Ac,DNA,2,0,1,0,3
HAT-N1_DEL,hAT-Ac,DNA,17,1,13,1,32
HAT-N1_DK,hAT-Ac,DNA,2,0,2,0,4
HB,P,DNA-transposon,1185,340,744,258,2527
HELENA_DS,Jockey,LINE,8590,774,4903,657,14924
HELENA,Jockey,LINE,321,54,205,46,626
HELENA_RT,Jockey,LINE,1094,24,642,20,1780
HELITRON-1_DANA,RC,DNA,15,8,13,6,42
HELITRON-1_DBP,RC,DNA,1564,25,922,22,2533
HELITRON-1_DEL,RC,DNA,60,1,31,1,93
HELITRON-1_DEU,RC,DNA,758,200,492,170,1620
HELITRON-1_DF,RC,DNA,70,28,49,22,169
HELITRON-1_DK,RC,DNA,32,9,28,6,75
HELITRON1_DMOJ,RC,DNA,304,25,229,18,576
HELITRON1_DM,RC,DNA,0,0,0,0,0
HELITRON-1_DPE,RC,DNA,70,10,55,9,144
HELITRON-1_DT,RC,DNA,391,105,303,90,889
HELITRON-1_DVIR,RC,DNA,245,63,196,52,556
HELITRON-1_DYAK,RC,DNA,284,90,221,62,657
HELITRON-1N1_DVIR,RC,DNA,85,26,75,16,202
HELITRON-1N_DF,RC,DNA,57,19,50,14,140
HELITRON-2_DBP,RC,DNA,427,149,252,129,957
HELITRON-2_DF,RC,DNA,2799,86,2644,71,5600
HELITRON-2_DRH,RC,DNA,742,455,628,406,2231
HELITRON-2_DVIR,RC,DNA,335,77,295,62,769
HELITRON-2N1_DVIR,RC,DNA,63,14,49,12,138
HELITRON-2N_DW,RC,DNA,57,21,51,19,148
HELITRON-3_DRH,RC,DNA,24,9,23,3,59
HELITRON-4_DRH,RC,DNA,108,6,82,3,199
HELITRON-5_DRH,RC,DNA,221,28,170,22,441
HELITRON-6_DRH,RC,DNA,81,13,72,7,173
HELITRON-7_DRH,RC,DNA,26,7,20,5,58
HELITRON-8_DRH,RC,DNA,9,4,8,1,22
HELITRON-9_DRH,RC,DNA,55,10,46,8,119
HELITRON-N1_DAN,RC,DNA,12,3,9,3,27
HELITRON-N1_DBI,RC,DNA,1605,299,1021,207,3132
HELITRON-N1_DBP,RC,DNA,104,15,75,7,201
HELITRON-N1_DEL,RC,DNA,220,38,185,34,477
HELITRONN-1_DPE,RC,DNA,89,30,73,22,214
HELITRON-N2_DBI,RC,DNA,410,281,376,259,1326
HELITRON-N2_DBP,RC,DNA,7,1,4,0,12
HELITRON-N2_DEL,RC,DNA,276,102,220,79,677
HELITRON-N2_DT,RC,DNA,158,57,123,42,380
HELITRON-N3_DT,RC,DNA,59,18,53,15,145
HET-A2_DVI,Jockey,LINE,385,304,356,296,1341
HET-A3_DVI,Jockey,LINE,293,70,216,46,625
HETA_DSI,Jockey,LINE,92656,1626,62553,1333,158168
HET-A_DV,Jockey,LINE,75,17,58,12,162
HETA,Jockey,LINE,39074,567,28267,403,68311
HET-A,Jockey,non-LTR-Retrotransposon,2761,481,2272,422,5936
HET-A-TAG,Jockey,non-LTR-Retrotransposon,5,0,1,0,6
HMS-BEAGLE2,Gypsy,LTR-Retrotransposon,1153,112,853,74,2192
HMS-BEAGLE,Gypsy,LTR-Retrotransposon,31595,602,22529,494,55220
HMSBEAGLE_I-INT,Gypsy,LTR,27918,748,17950,513,47129
HOANA1,hAT-hobo,DNA,3045,16,2289,12,5362
HOANA2,hAT-Ac,DNA,44,6,28,6,84
HOANA3,hAT-hobo,DNA,1498,23,1072,18,2611
HOANA4,hAT-hobo,DNA,21,3,21,3,48
HOANA5,hAT-Ac,DNA,130,45,102,32,309
HOANA6,hAT-Ac,DNA,63,34,47,26,170
HOANA7,hAT-Ac,DNA,58,18,47,11,134
HOANA8,hAT-hobo,DNA,17,13,15,10,55
HOBO,hAT-hobo,DNA,22238,490,15022,370,38120
HOGRI1,hAT-hobo,DNA,65,45,60,37,207
HOMO10,hAT-Ac,DNA,85,37,77,29,228
HOMO11,hAT-hobo,DNA,305,7,81,6,399
HOMO1,hAT-hobo,DNA,36,16,35,7,94
HOMO2,hAT-Ac,DNA,34,8,26,4,72
HOMO3,hAT-Ac,DNA,53,5,50,5,113
HOMO4,hAT-hobo,DNA,18,7,15,3,43
HOMO5,hAT-Ac,DNA,70,7,55,4,136
HOMO6,hAT-Pegasus,DNA,879,513,781,441,2614
HOMO7,hAT-Ac,DNA,8,3,7,2,20
HOMO8,hAT-Ac,DNA,352,7,275,5,639
HOMO9,hAT-Ac,DNA,27,17,25,15,84
HOPERS2,hAT-hobo,DNA,432,15,242,8,697
HOPERS3,hAT-Pegasus,DNA,466,11,127,10,614
HOPPER2,Transib,DNA-transposon,725,55,565,42,1387
HOPPER,Transib,DNA-transposon,1171,69,745,51,2036
HOPSEU2,hAT-Pegasus,DNA,235,24,175,19,453
HOVI1,hAT-hobo,DNA,14,6,10,4,34
HOVI2,hAT-hobo,DNA,60,37,51,17,165
HOWILLI1,hAT-Ac,DNA,653,10,541,8,1212
HOWILLI2,hAT-hobo,DNA,9,2,4,2,17
HOWILLI3,hAT-Ac,DNA,55,12,43,11,121
HOWILLI4,hAT-hobo,DNA,913,2,589,1,1505
HOWILLI5,hAT-hobo,DNA,11,8,8,7,34
HOYAK1,hAT-hobo,DNA,29,8,24,7,68
HOYAK2,hAT-Ac,DNA,419,174,327,143,1063
HOYAK3,hAT-Pegasus,DNA,33,15,32,11,91
I-10_DBI,I,LINE,9,5,7,2,23
I-1_DAN,I,LINE,6,1,4,1,12
I-1_DBI,I,LINE,7,4,7,3,21
I-1_DBP,I,LINE,12,6,10,6,34
I-1_DEL,I,LINE,22,11,20,9,62
I-1_DEU,I,LINE,24,14,20,13,71
I-1_DF,I,LINE,428,3,241,1,673
I-1_DK,I,LINE,41,20,36,17,114
I-1_DPE,I,LINE,37,7,32,6,82
I-1_DT,I,LINE,19,12,16,11,58
I-1_DVI,I,LINE,44,8,29,8,89
I-1_DWI,I,LINE,14,10,13,8,45
I-1_DYA,I,LINE,110,20,98,15,243
I-2_DAN,I,LINE,77,15,23,12,127
I-2_DBI,I,LINE,58,26,55,24,163
I-2_DBP,I,LINE,110,34,89,27,260
I-2_DEL,I,LINE,80,31,71,16,198
I-2_DEU,I,LINE,33,2,17,1,53
I-2_DF,I,LINE,13,4,10,4,31
I-2_DK,I,LINE,20,11,18,9,58
I-2_DVI,I,LINE,82,26,47,16,171
I-2_DWI,I,LINE,2448,879,1877,602,5806
I-2_DYA,I,LINE,54,19,36,13,122
I-3_DAN,I,LINE,68,11,63,8,150
I-3_DBI,I,LINE,29,3,25,3,60
I-3_DBP,I,LINE,17,7,11,7,42
I-3_DEU,I,LINE,132,30,107,26,295
I-3_DF,I,LINE,29,9,22,7,67
I-3_DK,I,LINE,11,4,9,2,26
I-3_DYA,I,LINE,172,10,96,5,283
I-4_DAN,I,LINE,232,158,203,156,749
I-4_DBI,I,LINE,1091,111,800,70,2072
I-4_DBP,I,LINE,241,73,184,68,566
I-4_DEU,I,LINE,237,168,217,136,758
I-4_DF,I,LINE,74,44,61,43,222
I-4_DK,I,LINE,70,12,52,10,144
I-4_DYA,I,LINE,51,13,43,10,117
I-5_DBI,I,LINE,14,6,10,6,36
I-5_DBP,I,LINE,12,5,12,5,34
I-5_DF,I,LINE,9,4,9,4,26
I-5_DK,I,LINE,47,8,27,6,88
I-6_DBI,I,LINE,410,8,387,8,813
I-6_DBP,I,LINE,21,3,15,3,42
I-6_DF,I,LINE,30,15,21,9,75
I-6_DY,I,LINE,1105,58,694,48,1905
I-7_DBI,I,LINE,373,7,291,6,677
I-7_DBP,I,LINE,213,5,147,5,370
I-8_DBI,I,LINE,21,9,16,7,53
I-8_DBP,I,LINE,27,7,21,6,61
IDEFIX,Gypsy,LTR-Retrotransposon,754,97,539,90,1480
IDEFIX_I-INT,Gypsy,LTR,2784,184,1926,147,5041
IDEFIX_I-INT:IDEFIX_LTR,Gypsy,LTR,3127,159,2284,140,5710
IDEFIX_LTR,Gypsy,LTR,1015,89,661,80,1845
IDEFIX_LTR:IDEFIX_I-INT,Gypsy,LTR,904,77,640,54,1675
I_DM,I,LINE,33789,706,25217,594,60306
I-ELEMENT,I,non-LTR-Retrotransposon,52591,491,36038,374,89494
INE-1,SINE,DNA-transposon,35407,2872,20803,2174,61256
INVADER1,Gypsy,LTR-Retrotransposon,9475,137,7117,95,16824
INVADER1_I-INT,Gypsy,LTR,1492,40,996,29,2557
INVADER1_I-INT:INVADER1_LTR,Gypsy,LTR,3277,24,2477,14,5792
INVADER1_LTR,Gypsy,LTR,3453,43,2897,33,6426
INVADER1_LTR:INVADER1_I-INT,Gypsy,LTR,4282,68,3153,54,7557
INVADER1_LTR:INVADER1_I-INT:INVADER1_LTR,Gypsy,LTR,1370,17,862,12,2261
INVADER2,Gypsy,LTR-Retrotransposon,1661,82,1182,66,2991
INVADER2_I-INT,Gypsy,LTR,3841,721,2991,695,8248
INVADER2_I-INT:INVADER2_LTR,Gypsy,LTR,1227,37,862,33,2159
INVADER2_LTR,Gypsy,LTR,354,7,210,5,576
INVADER2_LTR:INVADER2_I-INT,Gypsy,LTR,2543,97,1859,91,4590
INVADER2_LTR:INVADER2_I-INT:INVADER2_LTR,Gypsy,LTR,381,32,271,21,705
INVADER3,Gypsy,LTR-Retrotransposon,10557,200,7682,158,18597
INVADER3_I-INT,Gypsy,LTR,3568,93,1649,61,5371
INVADER3_I-INT:INVADER3_LTR,Gypsy,LTR,1947,53,1295,44,3339
INVADER3_LTR,Gypsy,LTR,1121,18,973,15,2127
INVADER3_LTR:INVADER3_I-INT,Gypsy,LTR,3727,61,2417,42,6247
INVADER3_LTR:INVADER3_I-INT:INVADER3_LTR,Gypsy,LTR,3001,81,1994,77,5153
INVADER4,Gypsy,LTR-Retrotransposon,348,49,247,41,685
INVADER4_I-INT,Gypsy,LTR,71,17,49,11,148
INVADER4_I-INT:INVADER4_LTR,Gypsy,LTR,13,1,7,1,22
INVADER4_LTR,Gypsy,LTR,45,3,27,3,78
INVADER5,Gypsy,LTR-Retrotransposon,1931,63,1397,48,3439
INVADER5_I-INT,Gypsy,LTR,283,30,196,25,534
INVADER5_I-INT:INVADER5_LTR,Gypsy,LTR,4,2,2,2,10
INVADER5_LTR,Gypsy,LTR,59,4,43,1,107
INVADER5_LTR:INVADER5_I-INT,Gypsy,LTR,9,4,8,2,23
INVADER6,Gypsy,LTR-Retrotransposon,2489,104,1928,83,4604
INVADER6_I-INT,Gypsy,LTR,3030,56,2163,43,5292
INVADER6_I-INT:INVADER6_LTR,Gypsy,LTR,1009,21,718,16,1764
INVADER6_LTR,Gypsy,LTR,258,4,189,3,454
INVADER6_LTR:INVADER6_I-INT,Gypsy,LTR,2418,46,1663,39,4166
INVADER6_LTR:INVADER6_I-INT:INVADER6_LTR,Gypsy,LTR,2696,31,1875,24,4626
ISFUN1,RC,DNA,134,18,99,16,267
IVK_DM,I,LINE,26275,658,17688,543,45164
IVK,Jockey,non-LTR-Retrotransposon,39326,423,25833,367,65949
JOCKEY-10_DAN,Jockey,LINE,22,14,21,13,70
JOCKEY-10_DBP,Jockey,LINE,243,96,224,68,631
JOCKEY-10_DEU,Jockey,LINE,9,4,7,4,24
JOCKEY-10_DF,Jockey,LINE,2982,999,2330,964,7275
JOCKEY-10_DRH,LTR,LTR,1374,53,798,39,2264
JOCKEY-10_DY,Jockey,LINE,227,72,176,53,528
JOCKEY-11B_DBP,Jockey,LINE,41,21,38,15,115
JOCKEY-11_DAN,Jockey,LINE,102,6,70,6,184
JOCKEY-11_DBP,Jockey,LINE,30,5,22,3,60
JOCKEY-11_DF,Jockey,LINE,27,13,23,9,72
JOCKEY-12_DAN,Jockey,LINE,84,24,63,14,185
JOCKEY-12_DBP,Jockey,LINE,1051,9,749,4,1813
JOCKEY-12_DF,Jockey,LINE,1,0,1,0,2
JOCKEY-13_DAN,Jockey,LINE,306,24,215,20,565
JOCKEY-13_DBP,Jockey,LINE,28,4,24,3,59
JOCKEY-14_DAN,Jockey,LINE,8,4,8,2,22
JOCKEY-14_DBP,Jockey,LINE,97,12,63,11,183
JOCKEY-15_DBP,Jockey,LINE,118,37,96,33,284
JOCKEY-1_DAN,Jockey,LINE,32,6,26,5,69
JOCKEY-1_DBI,Jockey,LINE,354,78,259,51,742
JOCKEY-1_DBP,Jockey,LINE,1031,288,792,275,2386
JOCKEY-1_DEL,Jockey,LINE,24,12,20,9,65
JOCKEY-1_DER,Jockey,LINE,3824,626,2495,573,7518
JOCKEY-1_DEU,Jockey,LINE,82,27,68,21,198
JOCKEY-1_DF,Jockey,LINE,216,138,191,115,660
JOCKEY-1_DGRI,Jockey,LINE,130,39,106,31,306
JOCKEY-1_DK,Jockey,LINE,220,129,202,102,653
JOCKEY-1_DPER,Jockey,LINE,48,20,42,11,121
JOCKEY-1_DRH,LTR,LTR,57,6,37,4,104
JOCKEY-1_DRO,Jockey,LINE,193,7,129,6,335
JOCKEY-1_DSE,Jockey,LINE,12826,212,8465,161,21664
JOCKEY-1_DSI,Jockey,LINE,25337,1980,16803,1843,45963
JOCKEY-1_DT,Jockey,LINE,97,17,73,10,197
JOCKEY-1_DVI,Jockey,LINE,140,40,106,30,316
JOCKEY-1_DWI,Jockey,LINE,162,6,143,5,316
JOCKEY-1_DYA,Jockey,LINE,7206,321,5328,263,13118
JOCKEY-2_DAN,Jockey,LINE,946,19,673,11,1649
JOCKEY-2_DBI,Jockey,LINE,79,56,70,51,256
JOCKEY-2_DBP,Jockey,LINE,35,17,31,14,97
JOCKEY-2_DEL,Jockey,LINE,31,7,27,4,69
JOCKEY-2_DEU,Jockey,LINE,95,8,63,5,171
JOCKEY-2_DF,Jockey,LINE,178,7,104,2,291
JOCKEY-2_DGRI,Jockey,LINE,249,126,210,87,672
JOCKEY-2_DK,Jockey,LINE,87,15,64,8,174
JOCKEY-2_DPER,Jockey,LINE,117,82,107,67,373
JOCKEY-2_DRH,LTR,LTR,436,295,394,243,1368
JOCKEY-2_DSIM,Jockey,LINE,4813,132,3021,89,8055
JOCKEY-2_DT,Jockey,LINE,407,11,229,9,656
JOCKEY-2_DVI,Jockey,LINE,40,18,38,17,113
JOCKEY-2_DYA,Jockey,LINE,17,2,15,2,36
JOCKEY2,Jockey,LINE,753,226,629,174,1782
JOCKEY-3_DAN,Jockey,LINE,126,65,117,51,359
JOCKEY-3_DBP,Jockey,LINE,588,29,314,24,955
JOCKEY-3_DEL,Jockey,LINE,39,17,33,11,100
JOCKEY-3_DEU,Jockey,LINE,58,23,46,13,140
JOCKEY-3_DF,Jockey,LINE,89,24,67,16,196
JOCKEY-3_DGRI,Jockey,LINE,6614,1838,5187,1506,15145
JOCKEY-3_DK,Jockey,LINE,92,13,64,9,178
JOCKEY-3_DPER,Jockey,LINE,646,138,444,112,1340
JOCKEY-3_DRH,LTR,LTR,363,19,256,16,654
JOCKEY-3_DSIM,Jockey,LINE,46531,1753,36157,1379,85820
JOCKEY-3_DT,Jockey,LINE,60,21,50,15,146
JOCKEY-3_DVI,Jockey,LINE,1676,94,635,69,2474
JOCKEY-3_DYA,Jockey,LINE,55,25,48,17,145
JOCKEY-4B_DVI,Jockey,LINE,114,32,86,24,256
JOCKEY-4_DAN,Jockey,LINE,440,18,429,14,901
JOCKEY-4_DBP,Jockey,LINE,49,17,32,9,107
JOCKEY-4_DEL,Jockey,LINE,56,14,50,11,131
JOCKEY-4_DEU,Jockey,LINE,19,8,15,5,47
JOCKEY-4_DF,Jockey,LINE,120,64,100,44,328
JOCKEY-4_DK,Jockey,LINE,174,117,161,45,497
JOCKEY-4_DPER,Jockey,LINE,650,501,597,488,2236
JOCKEY-4_DRH,LTR,LTR,310,32,131,31,504
JOCKEY-4_DSIM,Jockey,LINE,9824,105,6794,79,16802
JOCKEY-4_DT,Jockey,LINE,27,10,23,7,67
JOCKEY-4_DVI,Jockey,LINE,43,26,36,19,124
JOCKEY-4_DYA,Jockey,LINE,60,29,57,22,168
JOCKEY-5_DAN,Jockey,LINE,20,4,16,2,42
JOCKEY-5_DBP,Jockey,LINE,14,7,14,6,41
JOCKEY-5_DEL,Jockey,LINE,77,10,52,7,146
JOCKEY-5_DEU,Jockey,LINE,36,17,32,8,93
JOCKEY-5_DF,Jockey,LINE,10,5,7,2,24
JOCKEY-5_DK,Jockey,LINE,8,3,5,2,18
JOCKEY-5_DPER,Jockey,LINE,391,141,336,114,982
JOCKEY-5_DTA,Jockey,LINE,134,18,101,6,259
JOCKEY-5_DVI,Jockey,LINE,77,39,67,24,207
JOCKEY-5_DYA,Jockey,LINE,24404,852,15732,752,41740
JOCKEY-6_DAN,Jockey,LINE,169,15,101,11,296
JOCKEY-6_DBP,Jockey,LINE,12,4,9,4,29
JOCKEY-6_DEL,Jockey,LINE,406,10,323,4,743
JOCKEY-6_DEU,Jockey,LINE,538,30,149,23,740
JOCKEY-6_DF,Jockey,LINE,48,18,39,15,120
JOCKEY-6_DK,Jockey,LINE,1262,468,1109,362,3201
JOCKEY-6_DPER,Jockey,LINE,311,22,248,17,598
JOCKEY-6_DRH,LTR,LTR,52,19,44,14,129
JOCKEY-6_DVI,Jockey,LINE,157,51,141,41,390
JOCKEY-6_DYA,Jockey,LINE,278,38,198,29,543
JOCKEY-7_DAN,Jockey,LINE,16,6,15,6,43
JOCKEY-7_DEL,Jockey,LINE,112,45,85,38,280
JOCKEY-7_DEU,Jockey,LINE,42,17,31,16,106
JOCKEY-7_DF,Jockey,LINE,35,9,30,5,79
JOCKEY-7_DK,Jockey,LINE,18,0,12,0,30
JOCKEY-7_DPER,Jockey,LINE,170,6,77,5,258
JOCKEY-7_DRH,LTR,LTR,107,18,62,14,201
JOCKEY-7_DVI,Jockey,LINE,6,1,6,1,14
JOCKEY-7_DYA,Jockey,LINE,42,29,39,26,136
JOCKEY-8_DAN,Jockey,LINE,49,6,35,2,92
JOCKEY-8_DEU,Jockey,LINE,1887,694,1505,668,4754
JOCKEY-8_DF,Jockey,LINE,193,4,173,2,372
JOCKEY-8_DPER,Jockey,LINE,40,12,31,9,92
JOCKEY-8_DRH,LTR,LTR,217,15,146,9,387
JOCKEY-8_DVI,Jockey,LINE,45,23,40,16,124
JOCKEY-8_DYA,Jockey,LINE,109,10,91,8,218
JOCKEY-9_DAN,Jockey,LINE,1603,771,1354,747,4475
JOCKEY-9_DBP,Jockey,LINE,50,10,45,8,113
JOCKEY-9_DEU,Jockey,LINE,2,0,1,0,3
JOCKEY-9_DF,Jockey,LINE,130,16,76,9,231
JOCKEY-9_DPER,Jockey,LINE,75,50,69,40,234
JOCKEY-9_DRH,LTR,LTR,217,34,146,21,418
JOCKEY-9_DY,Jockey,LINE,1749,746,1490,714,4699
JOCKEY,Jockey,non-LTR-Retrotransposon,49208,829,31656,699,82392
JOCKEY-N1_DVI,Jockey,LINE,174,29,140,26,369
JUAN,Jockey,non-LTR-Retrotransposon,3761,41,2276,29,6107
KBOC_DB,P,DNA,42,21,33,6,102
KIRI-1_DBI,L2,LINE,21,10,13,7,51
KIRI-1_DEL,L2,LINE,92,39,72,37,240
KIRI-1_DF,L2,LINE,6,1,6,1,14
KIRI-1_DK,L2,LINE,237,32,161,29,459
KIRI-1_DPER,L2,LINE,40,12,30,9,91
KIRI-1_DRH,LTR,LTR,40,4,32,4,80
KIRI-1_DTA,L2,LINE,189,79,174,76,518
KIRI-2_DEL,L2,LINE,33,15,31,10,89
KIRI-2_DK,L2,LINE,12,8,11,6,37
KIRI-2_DPER,L2,LINE,51,5,30,2,88
KIRI-2_DTA,L2,LINE,21,8,20,6,55
KIRI-3_DK,L2,LINE,123,4,91,3,221
KIRI-3_DTA,L2,LINE,46,33,41,31,151
KIRI-4_DK,L2,LINE,8,4,7,3,22
KIRI-5_DK,L2,LINE,32,1,18,1,52
KIRI-6_DK,L2,LINE,207,36,150,34,427
KOLOBOK-1_DBP,Kolobok-Hydra,DNA,9,3,8,2,22
KOLOBOK-N1_DAN,Kolobok-Hydra,DNA,4,1,4,1,10
KOLOBOK-N1_DF,Kolobok-Hydra,DNA,7,4,6,2,19
LINEJ1_DM,Jockey,LINE,10726,371,6952,291,18340
LMESINE1C,tRNA-Deu-L2,SINE,30,3,24,1,58
LOA-1B_DPER,LOA,LINE,11,6,10,5,32
LOA-1B_DT,LOA,LINE,248,16,121,14,399
LOA-1C_DT,LOA,LINE,6,3,6,3,18
LOA-1_DAN,LOA,LINE,32,15,22,11,80
LOA-1_DBI,LOA,LINE,12,2,10,2,26
LOA-1_DBP,LOA,LINE,105,47,90,42,284
LOA-1_DEL,LOA,LINE,64,23,49,9,145
LOA-1_DGRI,LOA,LINE,15,5,11,5,36
LOA-1_DK,LOA,LINE,17,6,14,3,40
LOA-1_DPER,LOA,LINE,35,13,26,10,84
LOA-1_DPS,LOA,LINE,36,5,16,3,60
LOA-1_DRH,LTR,LTR,10,2,8,2,22
LOA-1_DT,LOA,LINE,14,7,14,5,40
LOA-1_DYA,LOA,LINE,73,40,59,31,203
LOA-2_DEL,LOA,LINE,26,11,23,8,68
LOA-2_DF,LOA,LINE,53,11,40,7,111
LOA-2_DGRI,LOA,LINE,29,19,27,9,84
LOA-2_DK,LOA,LINE,10,8,10,8,36
LOA-2_DPER,LOA,LINE,20,5,16,5,46
LOA-2_DTA,LOA,LINE,31,20,30,14,95
LOA-2_DYA,LOA,LINE,23,8,19,7,57
LOA-3_DEL,LOA,LINE,58,1,47,1,107
LOA-3_DPER,LOA,LINE,47,13,37,9,106
LOA-3_DTA,LOA,LINE,45,31,39,15,130
LOA,LOA,LINE,21,9,19,4,53
LOOPER1_DM,PiggyBac,DNA,394,42,362,31,829
LOOPER1,piggyBac,DNA-transposon,169,19,154,13,355
M4DM,CMC-Transib,DNA,35436,286,29009,232,64963
MAR_DW,hAT,DNA,1,0,1,0,2
MARINA,TcMar-Mariner,DNA,59,21,44,18,142
MARINER-10_DAN,TcMar-Tc1,DNA,3,2,3,2,10
MARINER-10_DBP,TcMar-Tc1,DNA,97,88,94,82,361
MARINER-10_DEL,TcMar-Tc1,DNA,205,10,165,7,387
MARINER-10_DF,TcMar-Tc1,DNA,16,13,16,10,55
MARINER-10_DK,TcMar-Tc1,DNA,20,2,11,2,35
MARINER-10_DRH,TcMar-Tc1,DNA,10,6,8,6,30
MARINER-11_DAN,TcMar-Tc1,DNA,19,11,13,9,52
MARINER-11_DBP,TcMar-Tc1,DNA,23,18,22,7,70
MARINER-11_DF,TcMar-Tc1,DNA,5,0,3,0,8
MARINER-11_DK,TcMar-Tc1,DNA,0,0,0,0,0
MARINER-11_DRH,TcMar-Tc1,DNA,75,3,73,3,154
MARINER-12_DAN,TcMar-Tc1,DNA,70,17,49,9,145
MARINER-12_DBP,TcMar-Tc1,DNA,917,5,357,4,1283
MARINER-12_DF,TcMar-Tc1,DNA,8,5,8,4,25
MARINER-12_DK,TcMar-Tc1,DNA,8,3,4,1,16
MARINER-12_DRH,TcMar-Tc1,DNA,35,5,30,2,72
MARINER-13_DAN,TcMar-Tc1,DNA,3,2,3,0,8
MARINER-13_DBP,TcMar-Mariner,DNA,5,1,5,1,12
MARINER-13_DF,TcMar-Tc1,DNA,4,3,4,2,13
MARINER-13_DK,TcMar-Tc1,DNA,291,3,255,2,551
MARINER-13_DRH,TcMar-Tc1,DNA,12,7,12,4,35
MARINER-14_DAN,TcMar-Tc1,DNA,320,1,186,1,508
MARINER-14_DBP,TcMar-Mariner,DNA,6,3,5,1,15
MARINER-14_DF,TcMar-Tc1,DNA,21,5,13,3,42
MARINER-14_DK,TcMar-Tc1,DNA,15,10,15,4,44
MARINER-14_DRH,TcMar-Tc1,DNA,6,5,6,4,21
MARINER-15_DAN,TcMar-Tc1,DNA,46,2,25,2,75
MARINER-15_DF,TcMar-Tc1,DNA,27,23,27,22,99
MARINER-15_DK,TcMar-Tc1,DNA,307,154,265,132,858
MARINER-15_DRH,TcMar-Tc1,DNA,17,4,16,2,39
MARINER-16_DAN,TcMar-Tc1,DNA,1,0,0,0,1
MARINER-16_DF,TcMar-Tc1,DNA,3,2,3,1,9
MARINER-16_DK,TcMar-Tc1,DNA,9,0,4,0,13
MARINER-16_DRH,TcMar-Tc1,DNA,23,7,22,5,57
MARINER-17_DAN,TcMar-Tc1,DNA,179,61,141,45,426
MARINER-17_DF,TcMar-Tc1,DNA,28,10,21,10,69
MARINER-17_DK,TcMar-Tc1,DNA,65,27,52,18,162
MARINER-17_DRH,TcMar-Tc1,DNA,0,0,0,0,0
MARINER-18_DAN,TcMar-Tc1,DNA,6,0,2,0,8
MARINER-18_DF,TcMar-Tc1,DNA,2,2,2,2,8
MARINER-18_DK,TcMar-Tc1,DNA,4,0,3,0,7
MARINER-18_DRH,TcMar-Tc1,DNA,5,4,5,2,16
MARINER-19_DAN,TcMar-Tc1,DNA,7,1,2,1,11
MARINER-19_DF,TcMar-Tc1,DNA,24,7,19,4,54
MARINER-19_DK,TcMar-Tc1,DNA,3,3,3,3,12
MARINER-19_DRH,TcMar-Tc1,DNA,39,32,36,31,138
MARINER-1_DAN,TcMar-Tc1,DNA,5,0,3,0,8
MARINER-1_DAR,TcMar-Mariner,DNA,0,0,0,0,0
MARINER-1_DBI,TcMar-Mariner,DNA,2,0,0,0,2
MARINER-1_DBP,TcMar-Tc1,DNA,0,0,0,0,0
MARINER-1_DEL,TcMar-Mariner,DNA,29,3,22,3,57
MARINER-1_DER,TcMar-Mariner,DNA,0,0,0,0,0
MARINER-1_DEU,TcMar-Tc1,DNA,5,3,5,3,16
MARINER-1_DF,TcMar-Mariner,DNA,6,2,6,1,15
MARINER-1_DGR,TcMar-Tc1,DNA,39,12,37,8,96
MARINER-1_DK,TcMar-Tc1,DNA,111,3,108,1,223
MARINER-1_DMAC,TcMar-Mariner,DNA,0,0,0,0,0
MARINER-1_DPE,TcMar-Mariner,DNA,23,8,20,3,54
MARINER-1_DRO,TcMar-Mariner,DNA,2,1,2,1,6
MARINER-1_DSIM,TcMar-Tc1,DNA,16142,247,7574,200,24163
MARINER-1_DT,TcMar-Tc1,DNA,250,26,177,25,478
MARINER-1_DVI,TcMar-Tc1,DNA,0,0,0,0,0
MARINER-1_DW,TcMar-Tc1,DNA,29,4,22,4,59
MARINER1_DYA,TcMar-Mariner,DNA,20,13,18,4,55
MARINER-20_DAN,TcMar-Tc1,DNA,92,29,67,22,210
MARINER-20_DF,TcMar-Tc1,DNA,6,1,4,1,12
MARINER-20_DK,TcMar-Tc1,DNA,87,6,74,1,168
MARINER-20_DRH,TcMar-Tc1,DNA,1,0,1,0,2
MARINER-21_DF,TcMar-Tc1,DNA,12,2,11,2,27
MARINER-21_DK,TcMar-Tc1,DNA,8,8,8,4,28
MARINER-22_DF,TcMar-Tc1,DNA,2,0,1,0,3
MARINER-22_DK,TcMar-Tc1,DNA,31,20,30,18,99
MARINER-23_DF,TcMar-Tc1,DNA,2,2,2,1,7
MARINER-24_DF,TcMar-Tc1,DNA,5,2,5,2,14
MARINER-25_DF,TcMar-Tc1,DNA,8,0,6,0,14
MARINER-26_DF,TcMar-Tc1,DNA,2,1,1,1,5
MARINER-27_DF,TcMar-Tc1,DNA,8,2,7,2,19
MARINER-28_DF,TcMar-Tc1,DNA,37,1,9,1,48
MARINER-29_DF,TcMar-Mariner,DNA,8,0,4,0,12
MARINER-2_DAN,TcMar-Tc1,DNA,18,15,18,10,61
MARINER-2_DBI,TcMar-Tc1,DNA,6,1,5,0,12
MARINER-2_DBP,TcMar-Tc1,DNA,1,1,1,1,4
MARINER-2_DEL,TcMar-Mariner,DNA,3,0,1,0,4
MARINER-2_DER,TcMar-Mariner,DNA,38,3,31,1,73
MARINER-2_DEU,TcMar-Tc1,DNA,33,3,16,3,55
MARINER-2_DF,TcMar-Mariner,DNA,57,53,54,50,214
MARINER-2_DK,TcMar-Tc1,DNA,44,9,30,8,91
MARINER-2_DMAC,TcMar-Mariner,DNA,1,0,1,0,2
MARINER2_DM,TcMar-Tc1,DNA,264,48,190,29,531
MARINER-2_DRH,TcMar-Tc1,DNA,10,1,10,1,22
MARINER-2_DRO,TcMar-Mariner,DNA,0,0,0,0,0
MARINER-2_DT,TcMar-Tc1,DNA,54,30,47,27,158
MARINER-2_DVI,TcMar-Tc1,DNA,30,3,20,3,56
MARINER-2_DYA,TcMar-Tc1,DNA,10,1,5,1,17
MARINER2,Mariner/Tc1,DNA-transposon,205,64,164,52,485
MARINER-30_DF,TcMar-Tc1,DNA,0,0,0,0,0
MARINER-3_DAN,TcMar-Tc1,DNA,0,0,0,0,0
MARINER-3_DBI,TcMar-Tc1,DNA,24,0,16,0,40
MARINER-3_DBP,TcMar-Tc1,DNA,1,1,1,0,3
MARINER-3_DEL,TcMar-Tc1,DNA,7,3,5,3,18
MARINER-3_DEU,TcMar-Tc1,DNA,25,15,21,14,75
MARINER-3_DF,TcMar-Mariner,DNA,1137,11,984,4,2136
MARINER-3_DK,TcMar-Tc1,DNA,0,0,0,0,0
MARINER-3_DRH,TcMar-Mariner,DNA,0,0,0,0,0
MARINER-3_DRO,TcMar-Tc1,DNA,4,1,3,1,9
MARINER-3_DT,TcMar-Mariner,DNA,4,3,4,1,12
MARINER-3_DYA,TcMar-Tc1,DNA,12,12,12,11,47
MARINER-4_DAN,TcMar-Tc1,DNA,11,1,10,0,22
MARINER-4_DBI,TcMar-Mariner,DNA,852,3,764,3,1622
MARINER-4_DBP,TcMar-Tc1,DNA,75,7,52,3,137
MARINER-4_DEU,TcMar-Tc1,DNA,50,47,48,46,191
MARINER-4_DF,TcMar-Tc1,DNA,12,2,11,2,27
MARINER-4_DK,TcMar-Tc1,DNA,68,4,44,1,117
MARINER-4_DRH,TcMar-Tc1,DNA,10,10,10,5,35
MARINER-4_DY,TcMar-Tc1,DNA,104,36,79,27,246
MARINER-5_DAN,TcMar-Tc1,DNA,83,72,81,70,306
MARINER-5_DBI,TcMar-Mariner,DNA,45,41,45,39,170
MARINER-5_DBP,TcMar-Tc1,DNA,8,0,5,0,13
MARINER-5_DEL,TcMar-Tc1,DNA,499,309,415,282,1505
MARINER-5_DEU,TcMar-Tc1,DNA,3,1,2,0,6
MARINER-5_DF,TcMar-Tc1,DNA,4,1,2,1,8
MARINER-5_DK,TcMar-Tc1,DNA,0,0,0,0,0
MARINER-5_DRH,TcMar-Tc1,DNA,178,12,143,10,343
MARINER-5_DY,TcMar-Tc1,DNA,0,0,0,0,0
MARINER-6_DAN,TcMar-Tc1,DNA,23,13,20,8,64
MARINER-6_DBI,TcMar-Tc1,DNA,605,11,416,9,1041
MARINER-6_DBP,TcMar-Tc1,DNA,3,0,2,0,5
MARINER-6_DEL,TcMar-Mariner,DNA,0,0,0,0,0
MARINER-6_DF,TcMar-Mariner,DNA,70,6,63,4,143
MARINER-6_DK,TcMar-Tc1,DNA,2,1,1,1,5
MARINER-6_DRH,TcMar-Tc1,DNA,19,4,16,3,42
MARINER-6_DY,TcMar-Tc1,DNA,49,3,35,3,90
MARINER-7_DAN,TcMar-Tc1,DNA,4,2,3,2,11
MARINER-7_DBI,TcMar-Tc1,DNA,8,0,4,0,12
MARINER-7_DBP,TcMar-Tc1,DNA,6,5,6,5,22
MARINER-7_DEL,TcMar-Mariner,DNA,10,4,9,3,26
MARINER-7_DF,TcMar-Mariner,DNA,7,1,2,1,11
MARINER-7_DK,TcMar-Tc1,DNA,88,2,49,2,141
MARINER-7_DRH,TcMar-Tc1,DNA,13,4,10,3,30
MARINER-7_DYA,TcMar-Tc1,DNA,75,46,67,34,222
MARINER-8_DAN,TcMar-Tc1,DNA,14,6,14,2,36
MARINER-8_DBP,TcMar-Tc1,DNA,1,0,0,0,1
MARINER-8_DEL,TcMar-Mariner,DNA,3,2,3,2,10
MARINER-8_DF,TcMar-Tc1,DNA,125,30,87,27,269
MARINER-8_DK,TcMar-Tc1,DNA,8,5,7,3,23
MARINER-8_DRH,TcMar-Tc1,DNA,229,91,184,83,587
MARINER-9_DAN,TcMar-Tc1,DNA,23,3,20,3,49
MARINER-9_DBP,TcMar-Tc1,DNA,261,258,261,251,1031
MARINER-9_DEL,TcMar-Tc1,DNA,16,4,13,2,35
MARINER-9_DF,TcMar-Tc1,DNA,5,0,3,0,8
MARINER-9_DK,TcMar-Tc1,DNA,5,2,5,2,14
MARINER-9_DRH,TcMar-Tc1,DNA,41,15,32,11,99
MARINER_DMA,TcMar-Tc1,DNA,51,22,33,15,121
MARN-1_DEU,TcMar-Mariner,DNA,26,8,19,3,56
MARN-2_DEU,TcMar-Tc1,DNA,907,2,579,1,1489
MARWOLEN1,TcMar-Tc1,DNA,15,1,3,1,20
MAX-ELEMENT,BEL,LTR-Retrotransposon,32978,897,23600,744,58219
MAX_I-INT:MAX_LTR,Pao,LTR,58391,530,41393,368,100682
MAX_I-INT,Pao,LTR,149371,1858,104112,1285,256626
MAX_LTR:MAX_I-INT:MAX_LTR,Pao,LTR,46073,361,30311,260,77005
MAX_LTR:MAX_I-INT,Pao,LTR,72843,607,49699,433,123582
MAX_LTR,Pao,LTR,3568,20,2259,15,5862
MCCLINTOCK,Gypsy,LTR-Retrotransposon,2481,33,1635,27,4176
MDG1,Gypsy,LTR-Retrotransposon,10800,617,7447,491,19355
MDG1_I-INT,Gypsy,LTR,23752,1192,16776,1028,42748
MDG1_I-INT:MDG1_LTR,Gypsy,LTR,441,16,308,11,776
MDG1_LTR,Gypsy,LTR,98,38,79,29,244
MDG1_LTR:MDG1_I-INT,Gypsy,LTR,65,7,43,5,120
MDG1_LTR:MDG1_I-INT:MDG1_LTR,Gypsy,LTR,56,9,40,5,110
MDG3,Gypsy,LTR-Retrotransposon,12493,155,7521,124,20293
MDG3_I-INT,Gypsy,LTR,2121,108,1309,92,3630
MDG3_I-INT:MDG3_LTR,Gypsy,LTR,2770,56,1701,49,4576
MDG3_LTR,Gypsy,LTR,533,2,354,2,891
MDG3_LTR:MDG3_I-INT,Gypsy,LTR,2318,46,1636,42,4042
MERLIN-1_DF,Merlin,DNA,3,2,2,2,9
MERLIN-1_DT,Merlin,DNA,81,21,48,19,169
MERLIN-2_DF,Merlin,DNA,1,0,0,0,1
MICROPIA_I-INT,Gypsy,LTR,2593,76,1023,67,3759
MICROPIA_I-INT:MICROPIA_LTR,Gypsy,LTR,141,7,80,7,235
MICROPIA_LTR,Gypsy,LTR,160,8,95,5,268
MICROPIA_LTR:MICROPIA_I-INT,Gypsy,LTR,2825,527,1610,505,5467
MICROPIA_LTR:MICROPIA_I-INT:MICROPIA_LTR,Gypsy,LTR,1585,25,573,18,2201
MICROPIA,-,LTR-Retrotransposon,1369,61,604,45,2079
MINOS,TcMar-Tc1,DNA,68,23,60,17,168
MUDR-1_DEL,MULE-NOF,DNA,578,22,396,17,1013
MUDR-1_DF,MULE-NOF,DNA,190,47,132,37,406
MUDR-1_DK,MULE-NOF,DNA,654,59,381,48,1142
MUDR-1_DT,MULE-NOF,DNA,73,15,54,11,153
NINJA_I-INT:NINJA_LTR,Pao,LTR,4512,194,2752,95,7553
NINJA_I-INT,Pao,LTR,10422,386,6058,289,17155
NINJA_LTR:NINJA_I-INT:NINJA_LTR,Pao,LTR,1379,20,956,14,2369
NINJA_LTR:NINJA_I-INT,Pao,LTR,3583,112,2143,79,5917
NINJA_LTR,Pao,LTR,617,29,446,22,1114
NINJA,-,LTR-Retrotransposon,10151,269,5152,215,15787
NOBEL_I-INT,Pao,LTR,895,117,742,98,1852
NOBEL_LTR,Pao,LTR,13,9,9,9,40
NOF_FB,MULE-NOF,DNA,24681,57,19488,39,44265
NOMAD_I-INT,Gypsy,LTR,10226,225,6098,156,16705
NOMAD_I-INT:NOMAD_LTR,Gypsy,LTR,2081,38,1557,28,3704
NOMAD_LTR,Gypsy,LTR,1704,16,1324,13,3057
NOMAD_LTR:NOMAD_I-INT,Gypsy,LTR,1716,37,1158,29,2940
NOMAD_LTR:NOMAD_I-INT:NOMAD_LTR,Gypsy,LTR,1426,9,1125,5,2565
OPUS,Gypsy,LTR-Retrotransposon,14845,307,11016,205,26373
OSVALDO_I-INT,Gypsy,LTR,210,84,143,77,514
OSVALDO_LTR,Gypsy,LTR,5,3,4,2,14
OUTCAST-1_DAN,Jockey,LINE,770,78,602,62,1512
OUTCAST-1_DBI,Jockey,LINE,25,10,21,8,64
OUTCAST-1_DBP,Jockey,LINE,5,0,4,0,9
OUTCAST-1_DEL,Jockey,LINE,132,53,101,46,332
OUTCAST-1_DEU,Jockey,LINE,119,14,98,8,239
OUTCAST-1_DT,Jockey,LINE,64,7,46,5,122
OUTCAST-1_DWI,Jockey,LINE,48,7,45,6,106
OUTCAST-2_DAN,Jockey,LINE,25,11,19,10,65
OUTCAST-2_DBP,Jockey,LINE,3,1,2,0,6
P-1_DBP,P,DNA,170,42,121,32,365
P-1_DRH,DNA,DNA,34,22,30,17,103
P-1_DY,P,DNA,2763,92,2174,67,5096
P-1N1_DBP,P,DNA,5,1,3,0,9
P-2_DRH,DNA,DNA,7,4,7,3,21
P-3_DRH,DNA,DNA,9,1,7,1,18
PARISA-1_DW,TcMar-Tc1,DNA,122,1,87,1,211
PARISA-2_DW,TcMar-Tc1,DNA,23,3,13,3,42
PARISA-5_DW,TcMar-Tc1,DNA,3,0,1,0,4
PARISA_DAM,TcMar-Tc1,DNA,0,0,0,0,0
PARISA_DAN,TcMar-Tc1,DNA,3,1,2,1,7
PARISA_DBU,TcMar-Tc1,DNA,10,3,9,2,24
PARISA_DEL,TcMar-Tc1,DNA,2,0,1,0,3
PARISA_DEQ,TcMar-Tc1,DNA,16,0,9,0,25
PARISA_DK,TcMar-Tc1,DNA,3,1,3,0,7
PARISA_DMO,TcMar-Tc1,DNA,66,2,58,1,127
PARISA_DPE,TcMar-Tc1,DNA,4,1,3,1,9
PARISA_DPOL,TcMar-Tc1,DNA,0,0,0,0,0
PARISA_DPS,TcMar-Tc1,DNA,3,2,2,2,9
PARISA_DRH,TcMar-Tc1,DNA,3,0,1,0,4
PARISA_DSU,TcMar-Tc1,DNA,0,0,0,0,0
PARIS,TcMar-Tc1,DNA,13,0,9,0,22
P_DB,P,DNA,20,7,19,5,51
P_DG,P,DNA,902,577,741,515,2735
PENELOPE-1_DEL,Penelope,LINE,2,1,1,1,5
PENELOPE-1_DF,Penelope,LINE,75,0,35,0,110
PENELOPE-1_DK,Penelope,LINE,4,4,4,4,16
PENELOPE-1_DRH,LTR,LTR,6,6,6,4,22
PENELOPE1_DW,Penelope,LINE,415,1,364,0,780
PENELOPE2_DW,Penelope,LINE,23,6,18,4,51
PENELOPE,Penelope,LINE,4,1,3,0,8
PIFO_I-INT,Gypsy,LTR,621,102,381,93,1197
PIFO_LTR,Gypsy,LTR,0,0,0,0,0
PIFO_LTR:PIFO_I-INT,Gypsy,LTR,35,28,31,23,117
PIGGYBAC-1_DAN,PiggyBac,DNA,196,67,139,65,467
PIGGYBAC-1_DBI,PiggyBac,DNA,3,1,3,0,7
PIGGYBAC-1_DBP,PiggyBac,DNA,2,0,1,0,3
PIGGYBAC-1_DEU,PiggyBac,DNA,11,6,9,6,32
PIGGYBAC-1_DF,PiggyBac,DNA,5,0,5,0,10
PIGGYBAC-1_DW,PiggyBac,DNA,474,7,364,5,850
PIGGYBAC-2_DAN,PiggyBac,DNA,63,9,37,8,117
PIGGYBAC-2_DBP,PiggyBac,DNA,9,4,8,3,24
PIGGYBAC-2_DEU,PiggyBac,DNA,25,7,19,6,57
PIGGYBAC-2_DF,PiggyBac,DNA,4,2,4,2,12
PIGGYBAC-3B_DAN,PiggyBac,DNA,3,1,2,1,7
PIGGYBAC-3_DAN,PiggyBac,DNA,4,1,4,1,10
PIGGYBAC-3_DBP,PiggyBac,DNA,37,8,29,8,82
PIGGYBAC-N1_DWIL,PiggyBac,DNA,0,0,0,0,0
PLACW_DM,P,DNA,24,3,19,3,49
POGON1,TcMar-Pogo,DNA,1,0,1,0,2
POGO,TcMar-Pogo,DNA,45,16,35,7,103
POLINTON-1_DAN,Maverick,DNA,557,233,446,213,1449
POLINTON-1_DBI,Maverick,DNA,97,19,63,11,190
POLINTON-1_DBP,Maverick,DNA,92,22,70,21,205
POLINTON-1_DEL,Maverick,DNA,1757,276,1273,241,3547
POLINTON-1_DEU,Maverick,DNA,64,35,50,30,179
POLINTON-1_DGR,Maverick,DNA,1098,400,830,366,2694
POLINTON-1_DK,Maverick,DNA,77,38,66,29,210
POLINTON-1_DPE,Maverick,DNA,688,36,532,24,1280
POLINTON-1_DY,Maverick,DNA,740,398,623,283,2044
POLINTON-2_DBI,Maverick,DNA,83,29,66,24,202
POLINTON-2_DBP,Maverick,DNA,356,4,284,4,648
POLINTON-2_DEU,Maverick,DNA,58,18,43,18,137
POLINTON-2_DK,Maverick,DNA,110,14,89,11,224
PORTO1,Jockey,non-LTR-Retrotransposon,638,31,373,28,1070
PROTOP_A,P,DNA,6281,140,3747,110,10278
PROTOP_B,P,DNA,16360,862,10342,696,28260
PROTOP,P,DNA,15355,423,11824,351,27953
Q-ELEMENT,Jockey,non-LTR-Retrotransposon,4816,54,4149,45,9064
QUASIMODO2-I_DM,Gypsy,LTR,4330,79,2842,63,7314
QUASIMODO2-I_DM:QUASIMODO2-LTR_DM,Gypsy,LTR,3522,43,2347,33,5945
QUASIMODO2-LTR_DM,Gypsy,LTR,1152,11,829,10,2002
QUASIMODO2-LTR_DM:QUASIMODO2-I_DM,Gypsy,LTR,6490,90,4475,73,11128
QUASIMODO2-LTR_DM:QUASIMODO2-I_DM:QUASIMODO2-LTR_DM,Gypsy,LTR,1446,18,1005,17,2486
QUASIMODO,Gypsy,LTR-Retrotransposon,3908,532,2690,442,7572
QUASIMODO_I-INT,Gypsy,LTR,954,67,626,56,1703
QUASIMODO_I-INT:QUASIMODO_LTR,Gypsy,LTR,5,2,5,2,14
QUASIMODO_LTR,Gypsy,LTR,186,64,165,53,468
QUASIMODO_LTR:QUASIMODO_I-INT,Gypsy,LTR,123,7,76,4,210
R1-10_DWI,R1,LINE,70,54,64,41,229
R1-11_DWI,R1,LINE,18,6,11,4,39
R1-12_DWI,R1,LINE,84,12,60,8,164
R1-13_DWI,R1,LINE,67,16,57,12,152
R1-14_DWI,R1,LINE,2089,43,1537,37,3706
R1-15_DWI,R1,LINE,23,17,22,15,77
R1-16_DWI,R1,LINE,149,5,95,2,251
R1-17_DWI,R1,LINE,11,2,10,2,25
R1-18_DWI,R1,LINE,2,0,0,0,2
R1-1B_DK,R1,LINE,9,6,9,5,29
R1-1B_DVI,R1,LINE,9,5,8,3,25
R1-1C_DK,R1,LINE,32,9,25,6,72
R1-1_DAN,R1,LINE,27,5,20,2,54
R1-1_DBI,R1,LINE,223,11,186,7,427
R1-1_DBP,R1,LINE,129,10,100,8,247
R1-1_DEL,R1,LINE,24,15,19,4,62
R1-1_DER,R1,LINE,143,30,98,23,294
R1-1_DEU,R1,LINE,14,8,12,4,38
R1-1_DF,R1,LINE,40,28,39,24,131
R1-1_DGR,R1,LINE,743,17,509,11,1280
R1-1_DK,R1,LINE,49,11,35,11,106
R1-1_DPER,R1,LINE,18,12,17,7,54
R1-1_DRH,LTR,LTR,260,191,246,176,873
R1-1_DSI,R1,LINE,132744,1471,99119,1024,234358
R1-1_DT,R1,LINE,612,4,242,2,860
R1-1_DVI,R1,LINE,95,28,49,16,188
R1-1_DYA,R1,LINE,327,90,279,68,764
R1-2B_DK,R1,LINE,90,40,85,32,247
R1-2_DAN,R1,LINE,124,17,105,11,257
R1-2_DBI,R1,LINE,30,23,28,17,98
R1-2_DBP,R1,LINE,50,11,36,8,105
R1-2_DEL,R1,LINE,23,9,23,8,63
R1-2_DEU,R1,LINE,436,23,327,10,796
R1-2_DF,R1,LINE,49,33,47,33,162
R1-2_DGR,R1,LINE,66,10,52,6,134
R1-2_DK,R1,LINE,22,4,13,1,40
R1-2_DM,R1,LINE,418,112,366,87,983
R1-2_DPER,R1,LINE,33,26,31,23,113
R1-2_DTA,R1,LINE,10607,435,3638,300,14980
R1-2_DVI,R1,LINE,562,207,463,82,1314
R1-2_DWI,R1,LINE,113,56,92,49,310
R1-2_DYA,R1,LINE,20,7,17,4,48
R1-2,R1,non-LTR-Retrotransposon,48,12,47,8,115
R1-3B_DEL,R1,LINE,130,33,101,27,291
R1-3_DAN,R1,LINE,65,14,48,8,135
R1-3_DBP,R1,LINE,37,31,35,13,116
R1-3_DEL,R1,LINE,31,13,30,11,85
R1-3_DEU,R1,LINE,59,32,51,21,163
R1-3_DF,R1,LINE,18,7,16,6,47
R1-3_DK,R1,LINE,56,39,51,36,182
R1-3_DPER,R1,LINE,21,16,18,12,67
R1-3_DVI,R1,LINE,8,4,7,2,21
R1-3_DWI,R1,LINE,16,11,14,5,46
R1-3_DYA,R1,LINE,214,111,183,86,594
R1-4B_DK,R1,LINE,163,25,100,14,302
R1-4_DAN,R1,LINE,269,13,202,7,491
R1-4_DBP,R1,LINE,51,34,43,26,154
R1-4_DF,R1,LINE,136,6,79,5,226
R1-4_DK,R1,LINE,44,22,34,18,118
R1-4_DPER,R1,LINE,36,11,31,8,86
R1-4_DVI,R1,LINE,10,2,7,1,20
R1-4_DWI,R1,LINE,129,80,116,75,400
R1-4_DYA,R1,LINE,2957,117,2482,98,5654
R1-5B_DK,R1,LINE,58,34,51,23,166
R1-5_DF,R1,LINE,17,11,16,11,55
R1-5_DK,R1,LINE,27,17,24,12,80
R1-5_DPER,R1,LINE,113,53,95,47,308
R1-5_DWI,R1,LINE,49,14,36,11,110
R1-5_DYA,R1,LINE,2267,70,1674,57,4068
R1-6_DK,R1,LINE,20,17,20,13,70
R1-6_DPER,R1,LINE,67,37,59,34,197
R1-6_DWI,R1,LINE,275,257,271,232,1035
R1-7_DK,R1,LINE,32,15,29,6,82
R1-7_DPER,R1,LINE,77,41,65,37,220
R1-7_DWI,R1,LINE,20,14,19,11,64
R1-8_DWI,R1,LINE,253,224,238,211,926
R1-9_DWI,R1,LINE,33,18,28,12,91
R1A_DAN,R1,LINE,241,43,191,34,509
R1A,R1,non-LTR-Retrotransposon,8622,329,6909,241,16101
R1B2_DAN,R1,LINE,18,5,15,3,41
R1B_DAN,R1,LINE,40,23,38,17,118
R1B_DVI,R1,LINE,30,14,27,4,75
R1_DER,R1,LINE,4036,51,3061,42,7190
R1_DMO,R1,LINE,133,85,122,65,405
R1_DM,R1,LINE,31289,597,23046,455,55387
R1_DPE,R1,LINE,37,14,30,9,90
R1_DPS,R1,LINE,186,91,171,72,520
R1_DSE,R1,LINE,10682,193,8264,136,19275
R1_DSI,R1,LINE,178835,3265,132213,2529,316842
R1_DVI,R1,LINE,390,207,350,192,1139
R1_DWI,R1,LINE,45,13,39,12,109
R1_DYA,R1,LINE,1409,365,1096,283,3153
R2-1_DWI,R2,LINE,33,7,28,6,74
R2-2_DWI,R2,LINE,30,6,12,5,53
R2B_DM,R2,LINE,1431,595,1100,463,3589
R2_DAN,R2,LINE,5,1,4,0,10
R2_DA,R2,LINE,13,11,12,5,41
R2_DM,R2,LINE,22435,113,17172,91,39811
R2_DPE,R2,LINE,86,78,82,78,324
R2_DPS,R2,LINE,12,9,11,3,35
R2_DSE,R2,LINE,724,34,580,26,1364
R2_DSI,R2,LINE,39317,1477,32974,1259,75027
R2_DYA,R2,LINE,340,16,293,10,659
REHAVKUS-1_DA,MULE-NOF,DNA,41,15,33,13,102
REHAVKUS-1_DY,MULE-NOF,DNA,6339,52,4813,40,11244
REP-2_DF,hAT?,DNA?,23,11,21,10,65
ROOA,BEL,LTR-Retrotransposon,52228,1765,35641,1431,91065
ROOA_I-INT,Pao,LTR,15165,217,9747,166,25295
ROOA_I-INT:ROOA_LTR,Pao,LTR,6314,115,4178,87,10694
ROOA_LTR,Pao,LTR,757,39,417,32,1245
ROOA_LTR:ROOA_I-INT,Pao,LTR,11494,170,7174,126,18964
ROOA_LTR:ROOA_I-INT:ROOA_LTR,Pao,LTR,5950,504,4000,242,10696
ROO,BEL,LTR-Retrotransposon,117570,952,72034,740,191296
ROO_I-INT,Pao,LTR,4735,549,3333,456,9073
ROO_I-INT:ROO_LTR,Pao,LTR,684,15,432,10,1141
ROO_LTR,Pao,LTR,784,23,462,15,1284
ROO_LTR:ROO_I-INT,Pao,LTR,703,6,455,5,1169
ROO_LTR:ROO_I-INT:ROO_LTR,Pao,LTR,94,0,57,0,151
ROVER,Gypsy,LTR-Retrotransposon,732,158,574,135,1599
ROVER-I_DM,Gypsy,LTR,100,5,83,5,193
ROVER-LTR_DM,Gypsy,LTR,40,10,25,7,82
RT1A,R1,non-LTR-Retrotransposon,3920,278,3289,205,7692
RT1B,R1,non-LTR-Retrotransposon,97658,1613,67953,1245,168469
RT1C,R1,non-LTR-Retrotransposon,9281,2829,7426,2535,22071
RTE-1B_DAN,RTE-BovB,LINE,9,5,8,2,24
RTE-1BN1_DAN,RTE-BovB,LINE,827,346,689,260,2122
RTE-1C_DAN,RTE-BovB,LINE,330,71,177,57,635
RTE-1_DAN,RTE-BovB,LINE,511,126,387,91,1115
RTE-1_DBI,RTE-BovB,LINE,3,2,3,2,10
RTE-1_DBP,RTE-BovB,LINE,98,81,92,74,345
RTE-1_DF,RTE-BovB,LINE,0,0,0,0,0
RTE-1_DT,RTE-BovB,LINE,3,2,3,1,9
RTE-1_DYA,RTE-BovB,LINE,27,19,25,13,84
RTE-2_DAN,RTE-BovB,LINE,5,2,2,2,11
RTE-2_DBP,RTE-BovB,LINE,36,11,31,11,89
RTE-2_DF,RTE-BovB,LINE,10,8,8,6,32
RTE-3_DF,RTE-BovB,LINE,4,1,4,1,10
RTE-4_DF,RTE-BovB,LINE,14,7,11,6,38
RTEX-1_DRH,LTR,LTR,13,10,13,9,45
RTEX-1_DT,RTE-X,LINE,35,4,21,2,62
RTEX-2_DT,RTE-X,LINE,100,13,92,7,212
S2_DM,TcMar-Tc1,DNA,45,7,37,5,94
S2,Mariner/Tc1,DNA-transposon,3341,35,2765,24,6165
S_DM,TcMar-Tc1,DNA,304,33,219,22,578
S-ELEMENT,Mariner/Tc1,DNA-transposon,18129,200,12046,139,30514
SOLA-1_DK,Sola,DNA,63,7,42,5,117
SPOCK_DMI,Jockey,LINE,187,22,149,17,375
SPRINGER,Gypsy,LTR-Retrotransposon,2985,312,2002,257,5556
STALKER2,Gypsy,LTR-Retrotransposon,46806,380,35060,300,82546
STALKER2_I-INT,Gypsy,LTR,464,50,284,29,827
STALKER2_LTR,Gypsy,LTR,82,6,67,6,161
STALKER2_LTR:STALKER2_I-INT:STALKER2_LTR,Gypsy,LTR,1294,37,936,28,2295
STALKER3,Gypsy,LTR-Retrotransposon,0,0,0,0,0
STALKER3_LTR,Gypsy,LTR,2,2,2,1,7
STALKER4,Gypsy,LTR-Retrotransposon,28206,1061,17640,917,47824
STALKER4_I-INT,Gypsy,LTR,10123,239,6831,177,17370
STALKER4_I-INT:STALKER4_LTR,Gypsy,LTR,3156,75,2039,58,5328
STALKER4_LTR,Gypsy,LTR,669,20,323,17,1029
STALKER4_LTR:STALKER4_I-INT,Gypsy,LTR,3141,53,2052,40,5286
STALKER,Gypsy,LTR-Retrotransposon,4564,266,3119,249,8198
TABOR_DA-I,Gypsy,LTR,1328,61,857,52,2298
TABOR_DA-LTR,Gypsy,LTR,8,0,7,0,15
TABOR,Gypsy,LTR-Retrotransposon,42003,137,31187,115,73442
TABOR_I-INT,Gypsy,LTR,24208,256,18125,237,42826
TABOR_I-INT:TABOR_LTR,Gypsy,LTR,19643,73,14500,66,34282
TABOR_LTR,Gypsy,LTR,2665,22,1893,15,4595
TABOR_LTR:TABOR_I-INT,Gypsy,LTR,1183,14,849,11,2057
TAHRE,Jockey,LINE,42027,809,36310,568,79714
TART-1_DWI,Jockey,LINE,12,6,10,4,32
TART-A,Jockey,non-LTR-Retrotransposon,3439,146,2287,114,5986
TART_B1,Jockey,LINE,58618,621,44823,530,104592
TART-B,Jockey,non-LTR-Retrotransposon,5,3,5,2,15
TART_DV,Jockey,LINE,7013,2159,5567,1870,16609
TART,Jockey,LINE,51191,971,39610,715,92487
TC1-2_DM,TcMar-Tc1,DNA,612,84,449,57,1202
TC1-2,Mariner/Tc1,DNA-transposon,409,295,367,285,1356
TC1_DM,TcMar-Tc1,DNA,850,86,480,74,1490
TC1,Mariner/Tc1,DNA-transposon,811,93,467,67,1438
TC3,Mariner/Tc1,DNA-transposon,175,144,160,125,604
TIRANT,Gypsy,LTR-Retrotransposon,17307,276,15897,225,33705
TIRANT_I-INT,Gypsy,LTR,10209,440,9070,345,20064
TIRANT_I-INT:TIRANT_LTR,Gypsy,LTR,1356,73,1202,64,2695
TIRANT_LTR,Gypsy,LTR,2461,17,1922,14,4414
TIRANT_LTR:TIRANT_I-INT,Gypsy,LTR,5340,152,4515,119,10126
TLD1,Gypsy,LTR,0,0,0,0,0
TLD2,Gypsy,LTR,21,0,12,0,33
TOM1,Gypsy,LTR-Retrotransposon,150,2,103,2,257
TOM_I-INT,Gypsy,LTR,9,5,9,4,27
TOM_LTR,Gypsy,LTR,2,0,0,0,2
TRAM_I-INT,Pao,LTR,12,1,8,1,22
TRAM_LTR,Pao,LTR,2,0,2,0,4
TRANSIB-10_DAN,CMC-Transib,DNA,575,10,534,5,1124
TRANSIB-11_DAN,CMC-Transib,DNA,36,5,22,4,67
TRANSIB1,CMC-Transib,DNA,18835,141,13050,119,32145
TRANSIB-1_DAN,CMC-Transib,DNA,47,9,26,7,89
TRANSIB-1_DBI,CMC-Transib,DNA,41,11,35,7,94
TRANSIB-1_DBP,CMC-Transib,DNA,55,2,34,1,92
TRANSIB-1_DEL,CMC-Transib,DNA,138,3,93,2,236
TRANSIB-1_DEU,CMC-Transib,DNA,4,2,4,1,11
TRANSIB-1_DF,CMC-Transib,DNA,51,23,35,12,121
TRANSIB-1_DK,CMC-Transib,DNA,48,19,36,14,117
TRANSIB1_DMOJ,CMC-Transib,DNA,50,10,38,6,104
TRANSIB1_DP,CMC-Transib,DNA,14,12,13,9,48
TRANSIB-1_DRH,CMC-Transib,DNA,852,163,678,125,1818
TRANSIB1_DWIL,CMC-Transib,DNA,55,5,43,4,107
TRANSIB2,CMC-Transib,DNA,16818,517,11045,451,28831
TRANSIB-2_DAN,CMC-Transib,DNA,41,0,28,0,69
TRANSIB-2_DBI,CMC-Transib,DNA,126,25,72,11,234
TRANSIB-2_DBP,CMC-Transib,DNA,62,3,39,3,107
TRANSIB-2_DEL,CMC-Transib,DNA,198,11,133,11,353
TRANSIB-2_DF,CMC-Transib,DNA,0,0,0,0,0
TRANSIB-2_DK,CMC-Transib,DNA,33,1,18,0,52
TRANSIB2_DP,CMC-Transib,DNA,112,3,87,3,205
TRANSIB-2_DRH,CMC-Transib,DNA,8,5,8,4,25
TRANSIB-2_DW,CMC-Transib,DNA,26,12,23,8,69
TRANSIB3,CMC-Transib,DNA,872,152,575,128,1727
TRANSIB-3_DAN,CMC-Transib,DNA,14,5,13,5,37
TRANSIB-3_DBI,CMC-Transib,DNA,31,8,26,4,69
TRANSIB-3_DBP,CMC-Transib,DNA,17,10,15,7,49
TRANSIB-3_DF,CMC-Transib,DNA,189,98,170,66,523
TRANSIB-3_DK,CMC-Transib,DNA,1,1,1,1,4
TRANSIB3_DP,CMC-Transib,DNA,52,10,44,7,113
TRANSIB-3_DRH,CMC-Transib,DNA,3,2,3,1,9
TRANSIB4,CMC-Transib,DNA,1949,312,1253,246,3760
TRANSIB-4_DAN,CMC-Transib,DNA,79,13,38,12,142
TRANSIB-4_DBI,CMC-Transib,DNA,23,1,15,0,39
TRANSIB-4_DBP,CMC-Transib,DNA,103,2,71,2,178
TRANSIB-4_DF,CMC-Transib,DNA,57,4,44,3,108
TRANSIB-4_DK,CMC-Transib,DNA,11,10,11,10,42
TRANSIB4_DP,CMC-Transib,DNA,36,8,28,7,79
TRANSIB-4_DRH,CMC-Transib,DNA,33,2,24,1,60
TRANSIB5,CMC-Transib,DNA,264,64,204,27,559
TRANSIB-5_DAN,CMC-Transib,DNA,25,2,14,2,43
TRANSIB-5_DBI,CMC-Transib,DNA,45,7,27,5,84
TRANSIB-5_DBP,CMC-Transib,DNA,148,17,98,16,279
TRANSIB-5_DK,CMC-Transib,DNA,328,10,237,2,577
TRANSIB-5_DRH,CMC-Transib,DNA,8,6,8,6,28
TRANSIB-6_DAN,CMC-Transib,DNA,123,5,75,3,206
TRANSIB-6_DBI,CMC-Transib,DNA,9,5,9,4,27
TRANSIB-6_DBP,CMC-Transib,DNA,335,10,210,5,560
TRANSIB-6_DK,CMC-Transib,DNA,8,5,7,1,21
TRANSIB-6_DRH,CMC-Transib,DNA,124,26,108,9,267
TRANSIB-7_DAN,CMC-Transib,DNA,11,5,10,3,29
TRANSIB-7_DBI,CMC-Transib,DNA,16,5,12,4,37
TRANSIB-7_DRH,CMC-Transib,DNA,578,17,381,11,987
TRANSIB-8_DAN,CMC-Transib,DNA,85,20,59,16,180
TRANSIB-8_DRH,CMC-Transib,DNA,28,6,19,2,55
TRANSIB-9_DAN,CMC-Transib,DNA,59,40,58,39,196
TRANSIB-N1_DM,CMC-Transib,DNA,258,35,199,24,516
TRANSIBN1_DP,CMC-Transib,DNA,32,6,25,6,69
TRANSIB-N1_DYA,CMC-Transib,DNA,8,5,8,4,25
TRANSIBN3_DP,CMC-Transib,DNA,233,9,176,7,425
TRANSIBN4_DP,CMC-Transib,DNA,5,0,3,0,8
TRANSIBN5_DP,CMC-Transib,DNA,12,2,4,1,19
TRANSPAC,Gypsy,LTR-Retrotransposon,5580,63,1838,54,7535
TRANSPAC_I-INT,Gypsy,LTR,1020,51,356,38,1465
TRANSPAC_I-INT:TRANSPAC_LTR,Gypsy,LTR,344,3,140,3,490
TRANSPAC_LTR,Gypsy,LTR,266,5,114,4,389
TRANSPAC_LTR:TRANSPAC_I-INT,Gypsy,LTR,518,3,186,2,709
TRANSPAC_LTR:TRANSPAC_I-INT:TRANSPAC_LTR,Gypsy,LTR,1193,17,365,11,1586
TRIM,LOA,LINE,8,4,8,4,24
TV1I,Gypsy,LTR,55,8,37,7,107
TV1LTR,Gypsy,LTR,0,0,0,0,0
UHU_DAN,TcMar-Tc1,DNA,23,7,18,2,50
UHU,TcMar-Tc1,DNA,4,1,4,1,10
ULYSSES_I-INT,Gypsy,LTR,1846,70,1309,46,3271
ULYSSES_LTR,Gypsy,LTR,55,48,53,44,200
UNKNOWN,unknown,unknown,0,0,0,0,0
UVIR_DV,Jockey,LINE,70,19,39,18,146
VEGE_DW,hAT-Tip100,DNA,21,19,21,15,76
WORF_DMI,CR1,LINE,175,13,84,13,285
XANTHIAS,-,Repetitive-sequence,695,10,542,8,1255
Y-ELEMENT,-,Repetitive-sequence,59,23,47,19,148
ZAM,Gypsy,LTR-Retrotransposon,92,11,76,4,183
ZAM_I-INT,Gypsy,LTR,24249,435,18119,368,43171
ZAM_I-INT:ZAM_LTR,Gypsy,LTR,22094,80,16744,57,38975
ZAM_LTR,Gypsy,LTR,2283,14,1771,10,4078
ZAM_LTR:ZAM_I-INT,Gypsy,LTR,19690,67,14977,58,34792
ZAM_LTR:ZAM_I-INT:ZAM_LTR,Gypsy,LTR,1598,12,1227,9,2846
ZATOR-1_DF,Zator,DNA,34,8,21,6,69
ZATOR-2_DF,Zator,DNA,5,4,5,4,18
